대통령을 포함한 미국의 행정부 견제권을 갖는 국가 기관은?	하원	[WHAT]
현대적 인사조직관리의 시발점이 된 책은?	《경영의 실제》	[CITE]
강희제가 1717년에 쓴 글은 누구를 위해 쓰여졌는가?	백성	[WHO]
11~12세기에 제작된 본존불은 보통 어떤 나라의 특징이 전파되었나요?	중국	[WHAT]
명문이 적힌 유물을 구성하는 그릇의 총 개수는?	4개	[QUANTITY]
카드모스의 부하들이 간 곳에는 무엇이 있었는가?	드래곤	[WHAT]
관우를 불태워 죽이려한 사람 누구인가?	형양태수 왕식	[WHO]
참호 속에 무기와 장비를 버리고 도주한 집단은?	이탈리아군	[WHAT]
제2차 세계 대전에 참전하여 사망한 자식은?	큰아들 유	[WHO]
고려 공민왕이 처가 식구들과 아내와 함께 피신처로 삼은 마을은?	왕대마을	[WHERE]
정여창은 어떻게 죽었나?	음독자살	[HOW]
아멜리아는 빅토르의 직업을 무엇으로 착각하나요?	출장 잦은 건축가	[WHAT]
우핑가스 왕조의 이름은 어디서 유래하였나?	반신화적인 인물인 우파	[WHERE]
장면이 한국으로 돌아온 년도는?	1951년	[WHEN]
유대교의 지나친 차별을 타파하려한 사람은?	예수	[WHO]
권번에서 요릿집에 제공한 기생 명부의 이름은?	'초일기'	[CITE]
영국군 약 42만명의 사상자가 발생한 전투가 시작된 연도는?	1916년	[WHEN]
웨이크필드가 15번째 시즌에 활약한 팀의 이름은?	레드삭스	[WHAT]
김상옥이 종로경찰서에 폭탄을 던진 직후 피신한 곳은?	삼판동	[WHERE]
윤치호가 극찬했던 조선시대의 인물은 누구인가요?	다산 정약용	[WHO]
항우가 진나라를 멸하면서 조왕 헐은 어디로 이동했는가?	대나라	[WHERE]
30일에 한달 연장 근무를 신청하는 병사가 상금으로 받게 되는 금액은?	10달러	[QUANTITY]
슈만이 미군에게 포로로 잡혔던 년도는?	1945년	[WHEN]
김건의 할아버지가 세운 학교는?	사립 김노인 고등학교	[WHERE]
뇌에 탈피 신호를 보내는 부위는?	체벽에 잇는 감지기	[WHAT]
툴민은 ≪코스모폴리스≫에서 근대과학과 무엇에 대해 비평하나요?	근대철학	[WHAT]
아테네와 파트라간의 거리는?	215km	[QUANTITY]
페리데코가 궁전으로 주문한 서재는 무엇으로 널리 알려져 있었나요?	마커트리로 장식을 한 트롱프 뢰유	[WHAT]
카르텔 내부의 세력 다툼이 일어나기 전 카르텔의 리더는 누구였나?	아르투로	[WHO]
개건 현대화의 계기가 된 승리자동차련합기업소의 생산 설비는?	조립 라인	[WHY]
잘록한 허리가 두드러지게 옷을 입는 방법은?	우전왕(優塡王)식 착의법	[WHAT]
도연주와 백승희는 무슨 사이로 알려졌나?	친구	[WHAT]
러시아가 ISIL과 타 반정부 단체와 전투를 벌인 년도는?	2015년	[WHEN]
비트겐슈타인은 누구와 친구가 되었는가?	케이스 커크	[WHO]
뷰포트는 대개 무슨 모양인가?	직사각형	[WHAT]
브루노 라이헨바흐의 직업은?	상인	[WHO]
차바하르항은 어떤 나라 덕분에 미국의 제재를 받지 않게 되었나?	중국	[WHAT]
항공기에 기름을 바르는 것은 누구의 일인가?	지상요원들	[WHO]
완장에 있는 별모양과 비슷한 모양의 빛을 뿜는 것은 누구의 손인가?	시조 거인	[WHO]
어린아이임에도 불구하고 도스필라스의 왕이 된 사람은?	'발라즈 찬 카이이'	[WHO]
KANU의 의장이었던 사람이 케냐 대통령이 된 날짜는?	1964년 12월 12일	[WHEN]
전기화학적 기울기가 ATP와 무엇을 만들어낼 수 있는가?	NADPH	[WHAT]
고든 프리맨이 레이븐홈을 떠날 수 있도록 도와준 사람은?	그리고리 신부(Father Grigori)	[WHO]
사후에 영장을 청구할 수 있는 예외조항이 존재하는 법 조항은?	헌법 제12조 제3항	[WHAT]
이범래는 일본에서 언제까지 도피 생활을 했나요?	1907년까지	[WHEN]
매사추세츠는 어느 지역의 사람들에게 공격을 받아 수많은 사람들이 죽었나?	부근 북동부	[WHERE]
초고층 주거에서 차량과 사람의 활동 범위 중복을 최소화하는 장치는?	덱	[WHAT]
풍수지리사상의 관점에서 보면 선몽대는 어떤 유형에 속하나요?	평사낙안형	[WHAT]
농지법을 개혁할 당시 카이사르의 직위는?	집정관	[WHO]
조에나 머레이 스미스가 여성주의를 비판한 것은 언제인가?	2004년	[WHEN]
BBC의 파란 경찰 박스 디자인 상표권에 대한 법적 논란이 종료된 해는?	2002	[WHEN]
도비가 아메리칸 리그에 데뷔할 수 있게 그를 발탁한 인물은?	빌 비크	[WHO]
이명한의 부탁을 외면한 인물의 지위는?	사대부	[WHO]
홀뮴이 평소와 다르게 강자성을 가지게 되는 온도는?	19 K 이하	[QUANTITY]
베커먼이 훔치려고 계획한 금괴는 어디에서 왔나요?	이탈리아 피아트 사	[WHERE]
경기를 홍보하기 위해 언급된 사람은?	임수정	[WHO]
트윈타워에서의 살인사건 현장에 있던 증거품은 무엇인가?	깨진 술잔	[WHAT]
작중 샤를 지 브리타니아가 비판한 사상은?	공산주의	[WHAT]
많은 갈등을 불러온 툴민의 책은?	≪인간의 이해: 개념의 집단적 사용 및 진화 (1972)≫	[CITE]
군인의 관례을 가장 잘 들어내는 문화는?	경례	[WHAT]
고급 외무 관리에 관한 권리와 미국 정부의 조약 비준권을 가진 기관은?	상원	[WHAT]
신 중심에서 인간 중심 사회로의 변화가 시작된 시기는?	14세기	[WHEN]
각절마다 미롱통 소리가 나오는 노래는?	〈마브루공(公)〉	[CITE]
차으르가 경계한 세력은?	마수드의 군대	[WHAT]
영국의 <원론> 번역본은 어떤 언어로 되어 있었는가?	라틴어	[WHAT]
대만에서 단일 태풍 강우량 신기록을 남긴 지역은?	핑둥현	[WHERE]
쾌속 《미에》 호는 어느 방향으로 직결 운행하는 열차인가요?	나고야	[WHAT]
호프만 폭동이 수습된 해는?	1753년	[WHEN]
을미사변 직후에 이범래는 무엇에 임명되었나요?	새로 조직된 훈련대의 제1대 대대장	[WHAT]
28인의 볼셰비키가 땅에 관련된 문제를 처리하고 싶었던 지역은?	장시성	[WHERE]
중세 초기의 스웨덴에서 역할을 제대로 수행하지 못한 것은?	왕권	[WHAT]
러시아를 근대화하려는 노력을 통해 근대 열강의 하나로 자리잡게 한 왕은?	표트르 1세	[WHO]
나오코는 미아코토와 소개팅을 한 후 누구와 집에 돌아갔는가?	하세가와 마나미	[WHO]
경찰관이 딱지를 떼지 않은 것은 무엇을 위해서인가?	독립 선언식	[WHAT]
농도산수가 일정하기 위한 전제조건은?	평형상태	[WHAT]
둠 3과 기존의 둠 게임에서 매번 지옥에 가는 인물은?	리더	[WHO]
에릭 레이먼드의 자유 소프트웨어 철학을 대변하는 글은?	〈성당과 시장〉(The Cathedral and the Bazaar)	[CITE]
클라리넷 외에 유니즌의 형태로 연주되는 악기의 이름은?	바순	[WHAT]
핀 막 쿠월이 복수하고자 하는 아버지의 적은?	골	[WHAT]
기원전 324년에 드리페티스의 결혼 상대는 누구의 동료였나요?	마케도니아의 장군 알렉산더 3세	[WHO]
이광은 감독이 LG트윈스를 매직리그 1위에 올린 해는?	2000년	[WHEN]
조지가 보트를 대여할 때 사용했던 이름은?	'길버트 에드워드'	[CITE]
독일의 바르바로사 작전은 어느 국가를 대상으로 한 것이었나?	소련	[WHERE]
오토망게어족을 가장 많이 사용하는 곳은 어디인가?	오아하카주	[WHERE]
가수 이난영의 노래 중 기념비까지 세워진 것은?	〈목포의 눈물〉	[CITE]
에케르트가 시행착오를 겪었던 국가는?	일본	[WHERE]
우메노의 사인은?	상사병	[WHAT]
비석에 새겨진 문자를 돌궐 문자라고 한 사람은 누구인가?	송기중 교수	[WHO]
일반 사람들이 합법적으로 문신을 하려면 누구를 찾아가야 하나?	의사	[WHO]
영국이 인도의 반영 운동을 무마시키고자 시행한 정책은?	벵골 분할령	[WHAT]
이명박 대통령이 직접 찾은 학교는?	마이스터고	[WHERE]
알랭 푸르니에의 매부는?	자크 리비에르	[WHO]
도카이도 신칸센이 지나가며 시나가와 역까지 가는 교통수단은?	도에이 버스	[WHAT]
《우리들의》에서 다루고 있는 가정은 어느 나라 사람들인가?	러시아인	[WHO]
선언형 프로그램과 대비되는 프로그램은?	명령형 프로그램	[WHAT]
한 마을 안에서 팀을 가를 경우에 사용하는 물건은?	장치게	[WHAT]
소나타의 시초가 된 연습곡을 만든 사람은?	도메니코 스카를라티	[WHO]
김대중을 구하기 위해 캐스퍼 와인버거 미 국방부 장관과 그레그 전 대사를 한국에 파견한 인물은?	로널드 레이건 대통령	[WHO]
정해진 기간동안 목표 금액에 도달하지 못할 경우 돈을 받지 못하는 사람은?	창작자	[WHO]
소프트 머신의 이전 명칭은?	와일드 플라워즈	[WHAT]
여운홍이 도움을 청한 사람은?	대통령 박정희	[WHO]
이사벨이 나라를 대신 통치할 수 있는 권위를 준 인물의 이름은?	페르난도	[WHO]
이익은 그대로 챙기면서 소비자에게 부담을 주는 방식을 시도해 코즈마케팅에 실패한 기업은?	도미노 피자	[WHAT]
개막전에서 3안타 2실점을 기록해서 패한 선수는?	와쿠이 히데아키	[WHO]
트윈 엘리베이터가 승강기 간의 충돌사고를 방지하기 위해 도입한 기술은 무엇인가?	티센크루프의 행선층 예약시스템인 DSC	[WHAT]
자기감시성향이 높은 사람들은 무엇과 관계있는 어휘를 접했을 때 긍정적인 개인행동을 보인다고 밝혀졌나요?	인상	[WHAT]
치과 시술 중 혈관 속으로 들어올 수 있는 것은?	세균	[WHAT]
존과 약혼한 여자의 이름은 무엇인가?	린다 우드로	[WHAT]
세종대 국제학부의 사업을 대학 특성화 사업으로 채택한 부처는 어디인가?	교육부	[WHERE]
맥스가 본사로 복귀하기 위해 활용한 인물은?	샘	[WHO]
클린턴의 두 번째 임기는 어떤 스캔들로 인해 내리막을 걷게 되었나?	화이트워터 사건	[WHAT]
어디에서 심학규의 눈이 떠졌는가?	맹인 잔치	[WHERE]
프레시오지테는 누구에게 다양한 방면으로 영향을 주었는가?	상류 여성	[WHO]
이스트미들랜즈 지국이 새롭게 갈라져 나간 해는?	1991년	[WHEN]
신비적 체험에 대해 '삶의 원천에서 깨끗하고 맑은 물을 마신 것 같다' 고 표현한 사람은?	소년 크리슈나무르티	[WHO]
베네딕토 16세가 영국 방문 이후 향한 곳은?	몰타	[WHERE]
메가비조스가 도시를 빼앗고, 나중에 생길 반란을 피하기 위해 부순 것은?	마르두크 신의 상	[WHAT]
인재에게 도전적인 일을 시키는 것은 가인지경영이 무엇에 중점을 두기 때문인가?	강점	[WHAT]
요자파트가 카를 프리드리히 가우스를 만나게 된 장소는 어디인가?	괴팅겐에 있는 자신의 삼촌의 은행	[WHERE]
무쇠시티 체육관 관장은?	강석	[WHO]
왕게민이 중일전쟁을 시작하기 전에 설립한 것은?	중화민국 임시정부	[WHAT]
루도비코가 비앙카와 결혼시킨 인물에게서 얻은 것은?	밀라노 공작칭호	[WHAT]
매년 해수온이 올라가는 현상으로 인해, 자리돔의 서식지가 어디까지 확장되었는가?	대한민국 동해	[WHERE]
알바니아계 이탈리아 교회가 소속된 교구는?	룬그로 (이탈리아 대륙에 거주하는 아르버레셔인을 위한) 교구	[WHAT]
내전으로 인해 어마어마한 부채를 떠안고 있는 인물은?	우주 제국의 코리노 황가의 황제인 사담 4세	[WHO]
나치 독일이 지식인이나 귀족 등 65000여 명의 폴란드인을 잡아들이기 위해 준비한 것은?	살생부	[WHAT]
확증 편향의 정의를 확립하게 된 연구는 언제 시작되었나요?	1960년	[WHEN]
치킨 누들 한 캔을 생산하기 위해 참여하는 회사의 수는?	56개	[QUANTITY]
시네마토그래프 유료 상영회가 개최된 날은?	1895년 12월 28일	[WHEN]
몽케 칸 다음으로 즉위한 인물은?	쿠빌라이	[WHO]
스태튼아일랜드의 영업은 언제 종료되었는가?	2001년	[WHEN]
연병환이 영국인 친구의 소개를 통해 구한 중국의 직장은 어디인가?	용정 해관	[WHERE]
플레이어가 용언 사용 훈련을 받은 장소는 어디인가?	세계의 목구멍	[WHERE]
인간의 의식 중, 사이코사이버네틱스를 통해 통제할 수 있는 것은?	잠재의식	[WHAT]
싱가포르 내 최초 감염자의 나이는?	66세	[QUANTITY]
마라도나는 벌칙 구역에서 누구와 대치했는가?	피터 실턴	[WHO]
프로이트의 정신 체계에서 현실적인 정신체계와 본능적 충동의 체계를 제외한 것의 명칭은?	‘전의식’(前意識)	[CITE]
옻칠의 가장 중요한 요소는 무엇인가?	우루시올(urushiol)	[WHAT]
가리발디의 원정으로 마리아 테레사는 어디를 떠나 해외로 도피했나요?	나폴리	[WHERE]
카보베르데의 저기압 순환의 원인이 된 것은?	북위 10도 남쪽의 대류	[WHY]
파이어폭스 이전 가장 잘나가던 웹 브라우저는?	인터넷 익스플로러	[WHAT]
선장의 일지를 확인하는 기관은?	위생위원회	[WHAT]
작곡가인 루이스 슈포어의 또 다른 직업은 무엇인가?	바이올리니스트	[WHAT]
남녀가 키스를 나눈 마을 이름은?	몬트하임	[WHAT]
일본의 원정 중 가장 최근의 원정은 언제 실행되었는가?	에도 말기	[WHEN]
토니왕의 조카에게 총을 쏜 자는?	이응	[WHO]
1955년부터 1973년까지 일본의 연평균 경제 성장률은?	연평균 10%	[WHAT]
아물라드의 아들이 밤베르크의 주교로 서임된 해는?	아물라드	[WHEN]
2014년 돈노드가 스퀘어 에닉스와 함께 작업한 이유는 무엇을 위해서인가?	디지털 유통	[WHY]
에르망가르드가 유부녀가 된 연도는?	1088년	[WHEN]
쌍곡 기하학 모형이 처음 등장한 책은?	《비유클리드 기하학의 해석에 대한 에세이》	[CITE]
마쓰카타 마사요시의 재정정책으로 가장 많은 타격을 입은 산업분야는?	농업	[WHAT]
철수가 피하려고 하지만 사실 친구로 생각하는 사람은?	노하라 신노스케	[WHO]
KT가 '쇼옴니아' 명칭을 사용하지 못하는 계기가 된 핸드폰은 어느 회사 제품인가?	애플	[WHY]
《논형》에 나오는 비판주의가 인정하지 않는 것은?	천인감응의 정통사상	[WHAT]
갈릴레오를 현대 과학의 아버지라 칭한 사람은?	알베르트 아인슈타인	[WHO]
스웨덴과 함께 겨울 전쟁이 끝나길 바란 국가는?	독일	[WHERE]
카를 체르니가 공연한 쾰른토나토아 극장은 어느 도시에 있는가?	빈	[WHERE]
수령자가 매매계약을 파기하기 위해서 지불해야하는 것은?	배액	[WHAT]
김용준이 도쿄 미술학교 재학 당시 만난 전통적 모더니즘 계열 화가는 누구인가?	이태준	[WHO]
코페르니쿠스가 교회법 박사 학위를 받은 날은?	1503년 5월 31일	[WHEN]
고등 의사소통 체계를 사용할 수 있는 인류의 종은?	호모 사피엔스	[WHAT]
마차시 성당을 모스크로 리모델링한 나라는?	오스만 제국	[WHERE]
브리에르에게 광서군 잔당을 축출할 것을 명령받은 사람은?	드 네그리에 장군	[WHO]
스빈후부드가 대통령 선거에서 승리한 연도는?	1931년	[WHEN]
카이가 22살에 한 일은?	리훈춘(Li Fuchun)과 결혼	[WHAT]
접어서 가지고 다닐 수 있는 풍금이 제작된 해는?	1843년	[WHEN]
푸르바더는 언제 세상 밖으로 나왔는가?	에흐네가 죽은 뒤	[WHEN]
햇빛으로 인해 생기는 물체의 그늘로 시간을 측정하는 기구는 무엇인가?	해시개	[WHAT]
조선인민공화국의 전신은?	조선건국준비위원회	[WHAT]
진대감의 부인중, 임신했다고 거짓말을 한 부인은 몇 번째 부인인가?	넷째 부인	[WHO]
윤치호가 중앙 정계에서 다시 활동하기 전에 일어난 전투는?	러일전쟁	[WHAT]
고려시대 때 마을의 걱정을 없애기 위해 만든 석불은 무엇으로 만들어졌나요?	화강암	[WHAT]
오다테의 난이 일어난 해는?	1578년	[WHEN]
예니체리가 완전히 해산되었을 시기 재위 중인 황제는?	마무드 2세	[WHO]
영국 해군이 다시 전장식으로 돌아가기를 결정했던 때는?	1864년	[WHEN]
카복실산과 반응하여 니켈 비누를 만드는 것은?	니켈 촉매	[WHAT]
정치하는 엄마들이 피해자들이 정상적인 일상생활을 할 수 있도록 돕기 위해 진행했던 서비스는?	무료 법률지원	[WHAT]
성작은 어느 종교에서 쓰이는 잔인가요?	기독교	[WHAT]
조기 심실 수축과 조기 심방 수축으로 나누는 기준은?	엇박자 맥박이 나오는 부위	[WHAT]
허계임과 그녀의 두 딸 중 가장 먼저 순교한 것은 누구인가?	이영희 막달레나	[WHO]
엘리노어 여사가 사망한 해는?	2007년	[WHEN]
체크포인트에 와서 총을 쏜 것은 누구인가?	무장 괴한	[WHO]
천연두에 감염된 모든 사례 중 출혈성 천연두는 얼마의 비중을 차지하는가?	약 2% 정도	[QUANTITY]
벳쇼 다케히코가 다이요 웨일스에서 코치로 활동하다가 그만둔 연도는?	1966년	[WHEN]
번역가가 기본적으로 문화와 함께 잘 알아야 하는 것은?	두 언어	[QUANTITY]
제 1차 바르바리 전쟁에서 지휘를 맡았던 사람은?	프레슬리 오배넌	[WHO]
아다케부네가 제작 된 시대는?	일본 전국시대	[WHEN]
《가우스전자》의 원래 제목은 무엇이었나?	《사이좋은 가우스전자》	[CITE]
벼농사와 관련된 이팝나무 전설의 관찰 대상은?	꽃	[WHO]
중국은 무엇을 통해 리덩후이의 총통 선거를 방해하려 했는가?	대규모 군사 훈련	[WHAT]
노선이 확대되기 전 열차의 객차는 몇 개였나?	6량	[QUANTITY]
파네 티치네세가 1킬로그램 가량의 무게였던 연대는?	1930년대	[WHEN]
혜주의 운전교습을 잠시 맡게된 인물의 형은?	경석(김규철 분)	[WHO]
오다 노부타다는 누구에게 살해당했나?	미쓰히데 군	[WHO]
위미르가 길들을 관할하는 곳은 어디인가?	'좌표의 세계'	[WHERE]
《하느님이시요 사람이신 그리스도의 시》는 누구의 생애를 다루고 있나요?	예수 그리스도	[WHO]
왕장이 성제에게 해임을 요청했던 인물은?	왕봉	[WHO]
여운형이 여러 소일을 하기전에 일했던 곳은?	조선중앙일보	[WHERE]
야기 바스티의 시라즈 침략을 도운 사람은?	마렉 아시라프	[WHO]
만덕사는 언제 설립되었나?	고려 전기	[WHEN]
평상시 기독교선교사들로부터 차별적 대우를 받은 윤치호가 생각한 미국의 중대한 속성은?	인종주의	[WHAT]
국무총리실에서 법에 어긋나게 조사했던 사람은 누구인가?	김종익	[WHO]
창문을 치며 희민에게 자신의 위치를 알리려고 했던 인물은 누구인가요?	소영	[WHO]
헤레로인이 독일기업이 예전에 나미비아에 큰 피해를 입힌 것에 대해 소송을 제기한 곳은?	미국 국제 재판소	[WHERE]
닥터와 함께 원형 판을 열었던 인물은?	아이다	[WHO]
보니파시오 4세는 로마의 무엇을 기독교 성당으로 중건하도록 명령했나요?	판테온	[WHAT]
주교좌직 중 상위라고 주장된 주교는?	셀레우키아크테시폰의 주교	[WHO]
설문지 질문을 작성할 때 질문에 꼭 포함시켜야 하는 것은?	문제의 핵심적 내용	[WHAT]
아달랴가 왕비가 된 것은 누구를 남편으로 맞아서인가?	여호람	[WHO]
마충의 상사는 누구인가?	반장	[WHO]
보니파시오 3세가 받은 칙령으로 피해를 입은 자는 누구인가?	콘스탄티노폴리스 총대주교	[WHO]
주인공 노바는 어떤 느낌을 지닌 캐릭터로 바뀌었나요?	동양적인 부드러움	[WHAT]
프로이트가 건강한 여성이 사춘기 이후부터 느껴야하는 오르가즘으로 주장한 것은?	질 오르가슴	[WHAT]
간의 약물대사에서 핵심적인 역할을 하는 효소는?	CYP효소	[WHAT]
태양 자전 속도의 약 60배 가량 속력을 낼 수 있는 항성은?	아케르나르	[WHAT]
슈타우펜베르크가 패전을 확신한 것은 몇 년인가?	1944년	[WHEN]
중국에서 쿨리가 공식적으로 해외에 나갈 수 있게 되었던 시점은 언제부터인가?	베이징 조약 체결 이후	[WHEN]
가나자와 성의 해자 중 현재는 소실되었지만 부속품이 남아 활용되는 것은?	햣켄 해자	[WHAT]
일반고 슬럼화 문제를 해결하기 위해 교육청에서 내세운 정책 슬로건은?	'일반고 점프업'	[CITE]
<가톨릭 청년>에서 참여를 촉구하는 발언은 누구의 말을 인용한 것인가요?	교황 비오 12세	[WHO]
킴푹은 무엇 때문에 3도 화상을 입었는가?	네이팜탄 불길	[WHY]
아스가르드에서 볼바와 같은 역할을 하는 인물의 가장 탁월한 점은?	마법	[WHAT]
해리엇은 어떤 업적으로 전 세계적인 이슈가 됐었나?	세계 최장수 기록	[WHAT]
사다트를 죽인 집단은 어느 국가와의 평화를 거부했나요?	이스라엘	[WHERE]
부르고뉴 공국의 영토가 프랑스 왕실에 반환된 법적 근거는?	살리카 법	[WHAT]
군 정부가 함부로 행사했던 연방 정부의 독자적 권리는 무엇인가?	유독성 폐기물 매립장 건설 인가권	[WHAT]
과도하게 공간을 점유한 주택의 철거를 자유화한 연도는?	1665년	[WHEN]
진주만 작전에서 제3차 공격강행을 반대한 인물은?	나구모 주이치(南雲忠一) 중장	[WHO]
고구려의 역사를 중국에게서 알아와 작성한 사서는?	삼국사기	[WHO]
비트겐슈타인의 의견을 잘 수용하지 못한 국가는?	영국	[WHERE]
고대 올림픽에 참가한 사람은?	알렉산드로스 1세	[WHO]
맥킨타이어가 일관성 있는 도덕이 아니라며 비난했던 것은?	계몽주의	[WHAT]
포브스에 의하면 1985년 자이르의 국채 규모는?	5억 달러	[QUANTITY]
회의주의 운동의 일부 주도자와 관련있는 사상은?	신무신론	[WHAT]
허셜이 관측한 이중성 중 쌍성으로 예측된 것은 몇 개인가?	700개	[QUANTITY]
금고를 걸어두기 위해 만들어진 것은 무슨 모양인가요?	반원형	[WHAT]
카스파는 어떤 역할을 담당해 베토밴을 도와주었나?	출판 경영	[WHAT]
이탈리아 동맹 결성에 가장 큰 영향을 준 나라는 어디인가?	프랑스	[WHERE]
아킬레우스의 무구를 받고 아이아스가 장례식을 치를 수 있게 설득한 인물은?	오디세우스	[WHO]
1757년 루이스버그 원정을 저지한 나라는?	프랑스	[WHERE]
콩은 옥수수와 달리 어떤 용도로도 쓰이는가?	기름을 만드는 데	[WHAT]
여운형과 함께 상하이에서 독립 운동에 전념한 사람은?	윤보선	[WHO]
로베스피에르가 처형된 쿠데타는 무엇인가?	테르미도르의 쿠데타	[WHAT]
분추류중 제일 컸다고 알려진 종류는?	프리오노수쿠스	[WHAT]
공성훈 작가는<낚시>와 <담배 피우는 남자(폭포)>에서 공통적으로 자연과 누구를 비교하는가?	사람	[WHO]
알렉산드로스 대왕이 창의 길이를 늘려 만든 것은 무엇인가요?	사리사	[WHAT]
아난 준로 감독이 감독으로 부임한 해에 리그 우승을 차지한 팀은?	히로시마 도요 카프	[WHAT]
무태장어 양식이 흔하게 이뤄지는 국가는?	중국	[WHERE]
성서를 영어로 번역한 인물에게 영향을 받은 사람은?	얀 후스	[WHO]
북한에서 다운로드 받아 플레이 할 수 있는 게임은?	슈퍼마리오 64 게임	[WHAT]
무기를 개편하기 위해 플레이어가 가지고 있어야 하는 것은?	별	[WHAT]
델라웨어 식민지의 이전 소유국가는?	네덜란드	[WHERE]
카르타고 신성대가 활동했던 시대는 언제인가?	기원전 310년	[WHEN]
섬의 꼭대기 부근에서 노랑부리백로와 공존하는 새는?	괭이갈매기	[WHAT]
한보철강의 부실대출 책임자 중 제일은행장이었던 사람은?	이철수	[WHO]
신여성 세력 중 한 인물이 대표를 맡았던 단체는?	근우회	[WHAT]
봉기군을 누르는데 앞장선 단체는?	이라크 공화국 수비대	[WHAT]
방사성 물질 운송에 비스무트를 사용할 수 있는 이유는?	중성자를 쉽게 흡수하지 않기 때문	[WHY]
알렉산드로스가 속한 군대는?	마케도니아군	[WHAT]
후난 지역과 장시 지역에서 농민봉기를 선동한 사람은?	마오쩌둥	[WHO]
루터가 보름스 청문회에 참여한 해는 언제인가요?	1521년	[WHEN]
인천에 이발소가 처음 생긴 해에 장면의 나이는?	9세	[QUANTITY]
여운형에 대한 생각이 적대적이였다가 긍정적으로 바뀐 조직은?	군정청	[WHAT]
데릭 쇼빈이 플로이드를 살해할 의도 없이 죽음에 이르게 하였기에 받은 혐의는?	3급 살인	[WHAT]
바실리 박이 안전을 위해 만나러 간 사람은?	트랴피친	[WHO]
영토를 넓히기 위해 대외정복사업을 추진한 백제의 왕은?	근초고왕	[WHO]
다나베가 구시로로 가기 위해 완공된 열차에 타고 있었던 시간은?	12시간	[WHEN]
보주에서 반란이 빈발한 시기는 언제부터인가?	16세기	[WHEN]
일반 사람들은 단종의 묘소를 뭐라고 부르곤 했나요?	노릉(魯陵)	[WHAT]
여러 음반을 EMI에서 발매한 인물의 전임자는 누구인가?	매리너	[WHO]
가내작업반에 대한 법률의 안건이 사회주의 상업법에 기록된 해는?	2004년	[WHEN]
교황 회칙 중 유일하게 독일어로 만들어진 것은?	《극도의 슬픔으로》	[CITE]
터키가 해외자본을 통해 철도를 깔기 시작한 년도는?	1856년	[WHEN]
이인영 의원이 밝힌 금액 중 월세와 함께 논란이 되는 것은?	생활비	[WHAT]
9월 23일 세이부 돔에서 진행된 경기에서 긴테쓰의 상대팀은 어디였나?	세이부	[WHERE]
스탈린이 철거한 계단이 복구된 것은 몇 년도인가?	1994년	[WHEN]
후크고지 최전선으로부터 500야드 거리에서 중공군을 발견한 부대는 어디인가?	바르샤바 정찰대	[WHERE]
시위 당시 라디오 간토의 기자가 부상을 입은 날짜는 몇 월 며칠인가?	6월 15일	[WHEN]
마윈은 누구의 도움을 받아 알리바바를 세웠나요?	제리 양	[WHO]
헤처의 내부가 좁고 가시성이 좋지 않은 원인은?	작은 차체	[WHY]
58군 사령부가 최후의 유격전을 준비한 것은 누구를 염두에 둔 것인가?	미 해병대	[WHO]
다수의 토착언어로 서로 다른 이야기로 표현된 시는 어느 나라의 것인가요?	인도	[WHERE]
트락티옹 아방을 생산한 회사가 위치한 나라는?	프랑스	[WHERE]
2015년에 개최되는 다른 대회 일정 때문에 피에가 참가하지 못했던 콘테스트는 무엇인가?	2015년 하계 유니버시아드	[WHY]
요한 3세가 선종한 후 교황이 된 인물의 부모는?	그리스인들에게 보노수스라고도 불리는 보니파시오	[WHO]
다스트가흐의 선율에서 고음을 내는 현과 함께 음을 조율하는 현은?	황색현	[WHAT]
의회로부터 받은 페린의 땅은 어느 정도인가?	93평방미터(36 평방마일)	[QUANTITY]
사회주의 운동을 지지하며 전개해나간 계층은 누구인가?	노동자계급	[WHO]
이다혜의 아버지는 무슨 종목을 하던 사람이었나?	핸드볼	[WHO]
프롱트낵 요새를 공격한 영국군의 지휘자는?	존 브래드스트리트 중장	[WHO]
키카이다와 권투사 군단이 결투를 벌였던 장소는?	몽골	[WHERE]
마리아는 어느 나라에 계속 머물러 있었나요?	이탈리아	[WHERE]
연여를 지키기 위해 조사에게 장수 역할을 맡긴 인물은?	혜문왕	[WHO]
서재필은 어디에서 공부하는 학생들을 독립협회로 모이게 했나요?	배재학당	[WHERE]
피아니스트이자 출판업을 하는 베토벤의 친구는	요한 B. 크라머	[WHO]
후쿠모리 복귀 시 라쿠텐 구단의 감독은?	노무라 가쓰야	[WHO]
스콜로펜드라신1은 무엇의 치료제로 사용되는가?	아토피 피부염	[WHAT]
지르가랑과 함께 부관직 지위를 맡은 인물은?	도르곤	[WHO]
짱구는 못말려 극장판: 초시공! 태풍을 부르는 나의 신부편'에서 알 수 있는 훈이의 장래희망은 무엇인가?	만화가	[WHAT]
역사 2층에 있는 역점을 전부 임대했던 곳은 어디인가?	에이잔 전철	[WHERE]
2002년 이후 대한민국이 동계 올림픽 아이스댄싱에 나간 것은 얼마만인가?	16년만	[WHEN]
베토벤이 병을 앓고 있는 신체 부위는?	귀	[WHAT]
콘늘라의 어머니는 누구인가?	알바의 여전사	[WHO]
창조신화는 누구에 의해 계획하고 실행된 것으로 그려지나?	초월적인 존재(신)	[WHO]
<신중현의 라스트 콘서트>가 초청된 곳은?	제3회 제천국제영화제	[WHERE]
성우는 본래에 어떤 계열의 직업인가요?	방송계	[WHO]
남은 뉴잉글랜드초원멧닭들을 떼죽음으로 몰고 간 병은?	흑두병	[WHAT]
구매와 저장을 위한 비용을 최소화하는 것을 우선으로 하는 물품 종류는?	상비품	[WHAT]
단청에 사용되는 기본 색은 몇 종류인가?	다섯가지 색	[WHAT]
시모시마 동부가 위치한 층은?	쓰시마층	[WHAT]
초창기 EBS온라인클래스의 문제들 중 빠른 속도로 시스템이 안정되면서 해결된 문제점은?	끊김	[WHAT]
도미니크 드빌팽이 제안한 최초고용계약에서, 고용인이 고용자를 쉽게 해고할 수 있는 기간은?	2년	[WHEN]
모모는 무슨 음식인가?	고기 만두	[WHAT]
기록상 여권을 가장 오래전에 사용한 인물은?	느헤미야	[WHO]
전문대학원 방식을 처음 도입한 곳은 보통 몇 년을 다니나요?	3년	[WHEN]
호남선은 언제 생겼나?	일제 강점기	[WHEN]
인종을 나눠 다니게한 학교는 언제 아예 없어졌나요?	1965년	[WHEN]
지붕 타일 전부를 보수하기 전 마지막으로 교체했던 시기는?	1810년대	[WHEN]
망코 잉카가 승전 후 이동했으나 스페인에게 함락당한 곳은?	비트코스	[WHERE]
연병호의 형제가 사망한 날짜는?	1926년 5월 14일	[WHEN]
갈릴레이가 이오와 유로파를 하나의 천체로 관측한 것은 몇 년도였나요?	1610년	[WHEN]
문정왕후 윤씨의 아들이었던 인물은 누구인가?	경원대군	[WHO]
아게실라오스가 추격대를 마련한 까닭은?	레오니다스를 죽이려고	[WHAT]
오래된 돈을 주기적으로 없애는 기관은?	중앙은행	[WHAT]
세상의 평화와 질서 유지를 위한 교육의 장은?	학교	[WHAT]
중공군이 예성강 입구에 잠복한 날짜는 언제인가요?	1951년 9월 28일	[WHEN]
논리형, 제한형 프로그래밍 언어와 대조되는 것은?	명령형 언어	[WHAT]
어머니가 사망했던 시점에 형국이는 무엇을 하고 있었나?	육군 병장으로 복무	[WHAT]
호한야 군이 우록리왕의 침입을 받은 시기는 언제인가?	기원전 56년	[WHEN]
샤를이 프랑크의 왕으로 선언된 해는?	978년	[WHEN]
오피온을 에덴 동산의 뱀과 동일한 존재라고 믿은 집단은?	영지주의자	[WHAT]
분화된 세포의 특징을 관찰하기 위해 필요한 것은?	빛 현미경	[WHAT]
카예스 대통령에 대한 가톨릭 교회의 저항은 몇 년에 일어났는가?	1927년	[WHEN]
클린턴이 연루 혐의를 받은 스캔들은?	화이트워터 사건	[WHAT]
언소주가 괴롭혔다고 알려진 중견기업은?	광동제약	[WHAT]
스즈키 다키히로한테 우측 타석에 서라고 지시한 감독은?	하라	[WHO]
조선미술가동맹 조선화분과에서 김용준이 맡은 직책은?	위원장	[WHO]
도비가 첫 감독을 맡게 된 팀은?	시카고 화이트삭스	[WHAT]
임영관 건물이 학교로 사용된 것은 언제인가?	일제시대	[WHEN]
벤자민 홉킨스는 누구에 의해 플로리다 민병대 지휘관이 되었는가?	토마스 브라운 주지사	[WHO]
아카이아 동맹의 리더 일부를 인질로 삼은 국가는?	로마	[WHERE]
카일의 입과 항문이 연결된 사람은 어느 나라 사람인가?	일본	[WHO]
미국 민주주의의 기원으로 여겨지는 것은?	개척시대의 부락회의(타운 미팅)	[WHAT]
연수취업제도에서 연수기간이 줄어든 해는?	2002년	[WHEN]
선원들을 선동하여 에스파니아 군함을 빼앗은 사람은?	마슈	[WHO]
DNA가 이중가닥을 형성할때 요구되는 상보성을 조절하는 방법은?	온도의 조절 또는 변성제 등의 이용	[WHAT]
라틴 음악의 기본 3요소 중 아르헨티나의 음악에서 찾아볼 수 없는 하나는?	흑인요소	[WHAT]
부모를 내다버리기 위해 아들을 설득한 인물은?	며느리	[WHO]
산사태가 일어난 당시 펑시 현의 3층 아파트 안에 있었던 사람은 모두 몇 명인가?	6명	[QUANTITY]
흥왕사명 청동은입사향완에서 갈대가 새겨진 부분은?	몸체	[WHAT]
바이러스 복제의 장소로 쓰이는 물질은 어떤 검사에서 쉽게 확인되나요?	생체조직검사	[WHAT]
다수의 미국 영화들이 최초로 상영될 뿐만 아니라 아카데미 시상식도 개최되는 곳은?	그로만즈 차이니즈 극장등의 할리우드의 역사적인 영화관	[WHERE]
마그누스 효과가 발표되기 전, 이 효과를 이용해 궤적의 편차를 설명한 인물은?	벤자민 로빈스	[WHO]
제도용 샤프가 아님에도 불구하고 스매쉬가 가지고 있는 것은 무엇인가요?	심경도 표시계	[WHAT]
이스라엘의 우파 정당이 동성 커플을 위해 제도적으로 혜택을 주고자 하는 부분은?	세제	[WHAT]
해리에게 생일 편지를 보낸 곳은 어디인가요?	호그와트 마법학교	[WHERE]
러시아의 막강한 군대는 핀란드의 어디로 침투하였나?	내륙	[WHERE]
중국 정교회를 소생시키려는 조치는 어떤 나라에 대처하기 위한 것인가요?	미국	[WHAT]
2016년에 화천군은 무엇때문에 통폐합 대상으로 선정되었나요?	인구 미달	[WHAT]
근래 몇 년동안 식물원이 눈에 띄게 번영하고 있는 국가는?	중국	[WHEN]
배곯는 아이들에게 도움이 된 식량 보급 제도는?	포전 담당 책임제	[WHAT]
북반구의 계절이 겨울로 변화되는 것은 지구가 어디에 가까워지기 때문인가?	근일점	[WHERE]
십자형의 무늬가 있는 돌은 탑의 어디에 위치하고 있나요?	탑신(塔身)	[WHERE]
박희옥이 국악의 발전에 도움을 주었음에도 불구하고 지원했다는 기록이 없는 이유는?	개인적인 차원의 후원이었기 때문에	[WHY]
홈즈는 어떤 전제 하에 싱클레어씨의 비밀을 발설하지 않기로 하였나?	다시 구걸을 하지 않는다는 조건	[WHAT]
탁바 호수내에 있는 섬의 갯수는?	1,331개	[QUANTITY]
갈티에르가 첫 리옹 감독으로 상대한 팀은?	마르세유	[WHAT]
틸이 시체로 발견된 것은 실종 후 얼마 뒤였나요?	사흘	[WHEN]
세카이와 코토노하가 마코토에게 줄 선물은 언제를 위한 것인가?	크리스마스	[WHEN]
아내가 부자를 괴롭히기 위해 사용한 것은?	술	[WHAT]
새터가을굿의 이전 명칭은?	공상타작놀이	[WHAT]
사우스캐롤라이나의 수익성 작물 이름은?	인디고 (쪽)	[WHAT]
제1차 세계 대전 당시 이집트를 지배하고 있던 나라는?	대영제국	[WHERE]
소크라테스가 나오기 전의 고대 그리스 철학자를 총칭하는 영어 단어는?	Presocratics	[WHAT]
가일의 부대의 유일한 생존자는?	독트린 다크	[WHO]
인도 정부가 반경 3마일 이내 접근을 금지하고 있는 곳은?	북센티널섬	[WHERE]
선선을 노리고 자주 공격한 집단은?	티베트계 강족의 일파인 스피	[WHAT]
양측에 올라가는 생김새의 쥐모양이 새겨져 있는 석조는?	망주석	[WHAT]
피핀2세가 가장 먼저 되찾은 땅은?	루아르 계곡	[WHAT]
비행기가 추락할 때 첫 번째로 떨어진 것은?	수직 안정체	[WHAT]
백인들이 핸콕 추장을 살해한 이유는?	백인들은 추장을 ‘부족 지배자’라고 믿고 있기 때문에	[WHY]
전투, 세계, 음악에는 높은 점수를 부여한 반면, 비주얼에서 부정적 평가를 내린 인물은?	레이너	[WHO]
독립운동의 구심점이 김구와 이승만 둘 다 아니라고 주장했던 인물은?	강덕상 교수	[WHO]
1712년에 남부 투스카로라 족은 누가 이끄는 부대로부터 공격을 받았는가?	존 반웰 대령	[WHO]
표현주의 화가 모임 다리파가 만들어진 곳은 어디인가?	드레스덴	[WHERE]
혜화동에 살 당시 장면의 직책은 무엇이었는가?	총리	[WHAT]
제노비아는 본인을 누구와 비교하여 '이집트의 여왕'이라고 하였나?	클레오파트라 7세 필로파토르 여왕	[WHO]
흑표당은 몇년도에 설립되었는가?	1966년	[WHEN]
남군의 소장들 중 힐이 가장 뛰어난 사람이라고 언급한 인물은?	로버트 E. 리 장군	[WHO]
아이톨리아 동맹이 로마의 통치를 받기 전 지지했던 인물은?	안티오코스 3세	[WHO]
박홍근이 이영주를 교살한 장소는?	영선국민학교	[WHERE]
10세기 압바스 왕조의 칼리파가 실세에서 물러난 것은 누구에게 정치권력을 넘기면서인가?	대(大)아미르	[WHO]
앨런의 각본의 기존 배경은 어디인가?	뉴욕	[WHERE]
뮈라가 나폴리의 왕으로 부임하기 전 직위는?	대공	[WHO]
블루어 연선의 손님이 빠르게 증가한 시기의 사건은 무엇인가?	2차 세계 대전	[WHAT]
도로 관계 4공단 민영화 이후로 니가타추오 분기점에서 아사히 나들목까지는 누가 관할하는가?	동일본 고속도로(NEXCO 동일본)	[WHO]
오라시오 엘리손도가 데뷔한 년도는?	2006년	[WHEN]
사사고 터널 내 환기는 어떤 방식으로 바뀌었나요?	제트팬이 설치된 종류식	[HOW]
조상이 나라를 장악하기 위해 고립시킨 사람은?	사마의	[WHO]
신이 상황을 생각하기 전에 의견을 말하는 인간으로 비친것은 후쿠다가 신을 무엇으로 그렸기 때문인가?	아이	[WHAT]
중형일개미는 잎을 나를 때 무엇의 위협을 받을 수 있나?	기생파리	[WHAT]
흑인들이 운행하던 물자 운송 부대를 타겟으로 삼던 것은 누구인가?	루프트바페	[WHO]
휘석과 달리 각섬석이 보유하고 있는 것은 무엇인가?	수산화이온	[WHAT]
중앙동·중거리·하거리 할아버지당 중 가장 높은 당산은?	하거리 할아버지당	[WHAT]
네드 핸런 감독은 맥그로를 어떤 포지션에 배치시켰는가?	정규적 3루수	[WHAT]
피사인들은 카스틸리오네를 무엇을 수비하는데 이용했는가?	티레니아 해	[WHAT]
포겐도르프가 <물리학사>를 출간한 년도는?	1897년	[WHEN]
집단 극화 현상은 주로 어떤 상황에서 흔히 일어날 수 있나요?	정치적 논쟁	[WHAT]
캐나다 국경 근처 요새를 차지한 혁명군이 잠시동안 지배했던 곳은 어디인가요?	세인트 존 마을	[WHERE]
돈 집단군에서 가장 크고 강력한 부대는 어디인가?	독일 제6군	[WHERE]
저상 트램 차량이 휠체어 높이 조절을 위해 조정하는 장치는?	브리지 판	[WHAT]
오스트리아 황태자 부부가 세르비아인에게 총살당한 사건은?	사라예보 사건	[WHAT]
2개 이상의 폴리펩타이드 사슬로 구성된 단백질 구조는 무엇인가?	단백질의 4차 구조	[WHAT]
제조업에서 직접투자의 대표적인 예는?	그린 필드 투자	[WHAT]
윤치호가 아버지 윤웅렬을 설득해 교회와 학교를 지을 땅을 제공했던 선교사의 이름은?	조세핀 애턴 캠밸	[WHO]
프린치프의 활동에 걸림돌이 되었던 그의 신체적 조건은?	키	[WHAT]
#BackOffIndia 해쉬태그 운동의 직접적인 계기가 된 언론사는?	디 이코노미 타임스	[WHY]
몇 년 전까지만 해도 한국의 삼포세대와 전혀 다른 모습이었으나 현재는 아닌 미국의 세대는?	밀레니얼스	[WHEN]
링컨빌에 차량 기지를 추가로 만든 이유는 무엇이 필요했기 때문인가?	추가 운행할 열차를 정박할 공간	[WHY]
윌리엄 피트의 명령서를 받은 사람은?	로던	[WHO]
비어가르텐을 이용해 세력을 불린 단체 중 SA가 소속된 단체는 어디인가?	나치당	[WHERE]
마리아 발토르타의 형제, 자매 관계는 어떻게 되나?	외동	[WHAT]
게오르크 프리드리히가 충성을 맹세한 국왕의 이름은 무엇인가?	스테판 바토리	[WHAT]
북아일랜드에 있는 평화선은 신교도와 무엇의 마찰을 막기 위해 만들어졌는가?	구교도	[WHAT]
중동신도시 개발에 기관 몇 곳이 적극적으로 뛰어들었나?	3	[QUANTITY]
탑에 시멘트를 바른 것은 언제인가?	일제강점기	[WHEN]
1801년 상산군부인 송마리아와 평산군부인 신마리아가 죽임을 당한 일과 관련있는 종교는?	천주교	[WHAT]
찰스 1세는 누구의 저항을 막기 위해 자금을 모으려 했나요?	아일랜드	[WHO]
거대 마젤란망원경에 사용되는 첫 번째 반사경이 만들어진 해는?	2005년	[WHEN]
노르망디 상륙 이후 등장한 보급대는?	리틀 레드볼 익스프레스	[WHAT]
세미놀과 협상을 시도했던 인물은?	윌리엄 S. 하니 준장	[WHO]
홍콩에서 영어학과 학위가 없는 교사들은 무엇을 통과해야 하는가?	LPAT	[WHAT]
하인리히 4세를 이용하여 모후를 섭정에서 물러나도록 요구한 인물은?	쾰른 대주교(안노 2세)	[WHO]
꿀풀목 가운데 가장 큰 과와 생김새가 비슷한 과는?	현삼과	[WHAT]
사망자들을 위한 합동위령제는 어디에서 진행되었나요?	교통부 앞 광장	[WHERE]
2008년 베이징 올림픽의 준결승전에서 리네르를 꺾었던 사람은?	우즈베키스탄의 압둘로 탕그리에프	[WHO]
장미의 붉은 색의 유래는 누구와 관련되어 있나?	아프로디테의 사랑을 받았던 소년 아도니스	[WHO]
튀코가 놋쇠로 된 보형물을 사용했다는 사실은 언제 알려졌는가?	2012년 11월	[WHEN]
문명호의 녕원군 이전 근무지는?	개천군	[WHERE]
정치 관련 책에서 전체주의와 전제 정치를 비교 서술한 학자는?	칼 요아힘 프리드리히	[WHO]
경성제국대학에서 학생들이 처음으로 수업을 받은 날짜는?	5월 12일	[WHEN]
스타필드 고양점이 개업한 날은?	3호점인 스타필드 고양	[WHEN]
나가이 겐지가 사망할 당시 가지고 있던 물건은?	카메라	[WHAT]
임팔 작전을 지휘한 사령관의 이름은?	무다구치 렌야	[WHO]
소순이 입관하는데 도움을 준 사람은?	구양수	[WHO]
통도사는 신라시대의 누구에 의하여 설립되었나요?	자장율사	[WHO]
센트럴 리그 올스타팀을 이끌었던 인물의 이름은 무엇인가요?	후지타 모토시	[WHO]
국문과 역사를 가르치던 곳에서 민족의지의 격려를 위해 불렀던 노래는 무엇인가?	애국가	[WHAT]
한국거래소와 한국예탁결제원이 여의도에서 옮겨간 도시는?	부산	[WHERE]
지석묘는 어떤 단어로도 불리나요?	고인돌	[WHAT]
담윤현에게 다양한 의술을 가르쳐 준 사람은?	할머니	[WHO]
키에스콤파스에 따르면 동성결혼 분야에서 리쿠드당, 베이테이누당과 정반대 성향을 보이는 이스라엘 정당은?	유대인의 집	[WHAT]
애플의 AS제도를 이용할 수 있는 기간은?	1년	[WHEN]
링컨이 조지 워싱턴 장군에 합세하여 우익을 통솔했던 전투는?	화이트 플래인스 전투	[WHAT]
펠레폰네소스 전쟁 당시 타사페르네스가 아테네와 동맹을 맺게 한 사람은?	알키비아데스	[WHO]
최근에 남편을 잃은 여자는?	도리멘 후작 부인	[WHO]
모투부가 참여한 원탁 회의는 어디에서 열렸나요?	브뤼셀	[WHERE]
강희제가 자식을 여러 명 낳는 데 영향을 준 자는?	부황 순치제	[WHO]
부여석조가 만들어진 시기는 언제인가?	백제시대	[WHEN]
야당 의원들이 장면을 대통령직에 올리기 위해 시도할 당시, 장면의 직책은 무엇이었나?	국무 총리	[WHAT]
호노리오 1세는 무엇을 이용해 단의설에 대한 주장을 내보여 문제를 피하였는가?	서신	[WHAT]
김성태 원내대표에 의하면 대한민국과의 외교 관계를 끊는다고 언급했던 인물은 누구인가?	UAE 왕세제	[WHO]
네르친스크 조약의 청나라 대표는 누구인가?	색액도	[WHO]
카드모스는 누구의 시중을 드는 형을 받았나?	아레스	[WHO]
블라미디르 푸틴이 보고 놀란 까마귀의 이름은?	토르	[WHAT]
리비아의 국기에 이슬람 국가라는 의미로 사용한 색깔은?	녹색	[WHAT]
제26회 사법시험과 16기 사법연수원 모두 수석이였던 사람은?	서동우	[WHO]
마하지의 공격을 받은 영국 군대가 후퇴한 곳은?	하두르	[WHERE]
비잔티움 제국 이전에 폰토스에 영향력을 행세한 국가는?	로마 제국	[WHERE]
국제 축구 및 우정의 날이 여러 국가에서 공휴일로 지정된 해는?	2014년	[WHEN]
천왕성과 해왕성에서 수소와 헬륨이 이루는 층은?	외곽층	[WHAT]
우생학 용어를 만들어낸 인물이 처음으로 우생학적 전망을 드러냈던 시기는?	1865년	[WHEN]
유숙열의 두 번째 근무지는?	미국 주재 조선일보	[WHERE]
헛소동의 배경이 되는 국가는?	스페인	[WHERE]
개신교회가 만든 대학교는 몇년을 수료해야 졸업할 수 있는가?	7년	[WHEN]
동양의 문화적 요소를 가장 잘 활용한 타란티노의 작품은?	《킬 빌》	[CITE]
연방 긴급 구조 법령을 통해 도움 받은 사람들은?	실업자들	[WHO]
장미십자회가 여러 곳에서 활동하기 위해 본거지로 삼았던 비밀스러운 곳은?	‘성령의 집’	[WHERE]
퀴리니우스는 인구조사를 언제 했는가?	서기 6년	[WHEN]
모린이 여자 유령의 형체를 처음 본 장소는?	루이스의 저택	[WHERE]
브라운이 플레이오프에 출전하기 위해 아이버슨에게 준 포지션은?	슈팅가드	[WHAT]
전쟁이 끝난 후 스코틀랜드 서약파가 찰스 1세를 지지하는 조건으로 인정받은 것은?	장로교	[WHAT]
하버드대학교의 설립연도는?	1636년	[WHEN]
당이 통일되던 해에 낭비성은 어느 국가의 영토였나?	고구려	[WHERE]
김준연에게 정부가 사전자금을 수수했다는 정보를 제공한 사람은?	장택상	[WHO]
1897년에 르베르디 아버지는 어디에서 일하고 있었나?	포도 농장	[WHERE]
제 4대 칼리프의 사촌형은 누구인가?	마호메트	[WHO]
9세기 후반 석탑에서 안상이 새겨진 부분은?	하층기단	[WHAT]
가르보치가 1992년 세계 아이스하키 선수권 대회에서 출전한 경기 수는?	6경기	[QUANTITY]
최종훈이 음주운전으로 검거되었을 때 얼마를 주고 경찰관을 매수하려 했나?	200만원	[QUANTITY]
술탄이라는 이름의 아이디어를 제공한 사람은?	윤덕원	[WHO]
코시안 어린이들이 자주 차별을 받는 사유는?	생김새	[WHAT]
X선과 적외선의 효과가 미치지 못하도록 시멘트에 첨가하는 성분은?	납	[WHAT]
성화상 원본이 후스파의 공격으로 크게 상한 해는?	1430년	[WHEN]
1616년 만주를 통합하고 후금국을 건국한 인물은?	누르하치	[WHO]
하나님이 생각하는 그리스도인과 유대인이 상이하다고 생각한 인물은?	바울	[WHO]
남한군의 도주를 막기위해 설치되었던 것은?	말뚝	[WHAT]
웃는 감정을 그대로 표현한다는 뉘앙스를 갖는 ㅋ의 용법은?	ㅋㅋㅋ	[WHAT]
김은환이 졸업한 대학의 소재지는?	평양	[WHERE]
게를리히는 누구의 제보를 기사화했다가 히틀러에게 쫓기게 되는가?	게오르크 벨(Georg Bell)	[WHO]
해왕성 위성계에서 가장 많은 질량을 차지한 위성은?	트리톤	[WHAT]
법정에서 '피고인'이라는 용어와 같이 쓰이는 용어는?	피의자	[WHAT]
병변이 심각한 경우에는 무엇까지 발생할 수 있나요?	각막 궤양	[WHAT]
천지 괴물에 대한 목격담은 어느 시기에서부터 시작되었나요?	청나라 때	[WHEN]
대한민국의 일부 로맨스 드라마에서, 여성 주인공은 높은 지위의 남자를 만나 어떤 결과를 맞이하는가?	사회적 신분을 상승	[WHAT]
소남 갸초는 언제 달라이 라마로 즉위하였는가?	1578년	[WHEN]
보닌과 마일리가 가고자 한 도시는?	헐리우드	[WHERE]
베링이 독일 말을 쉽게 구할 수 없었던 이유는 무엇 때문인가?	제1차 세계대전	[WHY]
1968년 대선 당시 후보로 출마된 수퇘지의 이름은?	피가수스	[WHAT]
데니소바 동굴에서 처음으로 인류의 화석이 발견된 년도는?	2008년	[WHEN]
곡면구조의 액정은 어디에 약한가요?	충격	[WHERE]
쿠셸이 신분을 숨기며 매춘부 일을 한 것은 누구를 피하기 위해서였나?	중앙 헌병단	[WHO]
독립채산제를 적용한 경제 관리 방법을 공표한 인물은?	김정은	[WHO]
강을 수호하면서 죽은자들을 강 쪽으로 보내는 직책을 맡고 있는 자는?	플레기아스	[WHO]
미국 기업이 선호하는 나라는 어떤 것이 저조한가요?	출산율	[WHAT]
데스볼트는 무엇이 결여되어있나?	감정	[WHAT]
할머니가 노이에 대한 걱정을 이야기했던 인물은?	길피	[WHO]
갈릴레오가 화산 필란 파테라의 폭발을 관측해서 얻어낸 것은?	화산 폭발로 분출된 물질의 구성	[WHAT]
"""잃어버린 세대를 위한 희망""의 한 부분을 제시했으며 아일랜드 경제를 신자유주의적 관점에서 바라본 사람은?"	레오 바라드카르	[WHO]
판스워스 교수가 이전 배달원에 대해 한 대사는?	"""오 그 불쌍한 사람들... 그러나 그건 별로 중요하지 않아요! 중요한건 난 새로운 배달원이 필요했다는 거지!"""	[CITE]
무변론판결에서 소송 당한 사람이 법원에 내야하는 서류는 무엇인가요?	답변서	[WHAT]
관여도 수준은 어느 분야에서 적절한 요소로 쓰일 수 있나요?	마케팅	[WHAT]
미슈텍어파 언어들의 확산의 시발점이 된 곳은?	라미스테카	[WHERE]
김홍일은 자신이 살인한 자매 중 언니와 언제부터 사귀었다고 했나?	2010년	[WHEN]
샴쉬르나 시마타와 유사한 칼은?	편도(片刀)	[WHAT]
카르타고 시민 보병대가 역사 기록에서 없어진 시기는?	기원전 310년의 전멸 이후	[WHEN]
리싸 해전의 패전국은?	이탈리아	[WHERE]
파울이 포로 생활을 한 나라는?	러시아	[WHERE]
사람들은 무엇으로 가득한 기억을 쉽게 떠올리지 못하나?	고통	[WHAT]
인도 정부는 어느 기관의 지시에 따라 '래깅 방지 헬프콜'을 시행했나요?	대법원	[WHAT]
바냐가 신발명품인 번개 지팡이에 관한 이야기로 위로하려 했던 인물은?	디코이	[WHO]
영남 지방은 소백산맥의 어디에 위치해있나요?	동남부	[WHERE]
향토문화축제의 개최지는?	보령	[WHERE]
라지야팔라의 통솔 기간은?	12년	[WHEN]
"""콘술 이전""이라는 의미를 생각해낸 사람은?"	아서 홉우드	[WHO]
케네디 대통령의 동생이 연방 상원 선서를 시행한 것은 몇년도인가?	1962년	[WHEN]
트위터 내에서 외부 광고가 가능한 사람은?	유명인사들	[WHO]
여운형으로 하여금 신분차별을 반대하게 만든 인물은?	부친	[WHO]
동국전자초급대학이 창립된 해는?	1962년	[WHEN]
1497년 초 코페르니쿠스 집주인의 전공은?	천문학	[WHAT]
조선로동당에서 곡물 소득량을 늘릴 수 있게 농장 간부들에게 자체적으로 시행하도록 허가한 제도는?	포전 담당 책임제	[WHAT]
펠로피다스가 추방당한 것은 몇 년인가?	기원전 385년	[WHEN]
부산광역시에서 비가 가장 많이 온 곳은?	남구	[WHERE]
강중인이 경제사범을 비판하며 국민의 일대수치라 표현한 글은?	최근의 반도의 경제사범 ­국민의 신경제 윤리의 파악을 위하여­	[WHAT]
경험주의를 배운 작가들을 부르는 명칭은 무엇인가요?	철학자	[WHAT]
게바라가 7월 23일 오후에 간 곳은 어디인가?	신미쯔비시 중공의 비행기 제작장	[WHERE]
세형동검의 등날은 어디까지 이어지나?	칼몸 끝	[WHERE]
정하상 바오로는 누구를 위해 돈을 장만했나?	외국인 선교사들	[WHO]
사이판의 전선과 하수구 파이프는 언제 수리하기 시작했는가?	태풍 초이완이 지난 후	[WHEN]
한일어업협정에서 분쟁의 씨앗으로 남긴 곳은?	독도 인근	[WHERE]
스웨덴이 왕국으로 건립 된 시기는?	기원후 2세기	[WHEN]
줄리와 함께 식사한 사람은?	스튜어트	[WHO]
카도쿠라 켄이 7이닝 퍼펙트게임을 달성할 때 있던 팀은?	다테 히지리가오카 병원 경식 야구부	[WHAT]
갓난아기의 딸국질을 멎게 하려면 아기한테 무엇을 주는 것이 좋은가?	마실 것	[WHAT]
1646년 요절한 인물의 부친은?	펠리페 4세	[WHO]
신자유' 모형을 제시한 집단은?	이데올로기에 심취한 경제학자의 한 무리	[WHAT]
자리돔이 암컷을 산란소로 유인하는 시기는 언제인가?	5-8월	[WHEN]
나탄이 젊은 부부에게 기꺼이 주려고 했던 것은 무엇인가?	목숨	[WHAT]
땅 속에서부터 만드는 고인돌 방식은?	바둑판식	[WHAT]
노태우는 몇 대 대통령인가?	제13대	[WHO]
광고에 관련하여 불매운동이 일어난 회사는?	광동제약	[WHAT]
돔 모양의 천막 지붕은 무엇을 모티브로 한 디자인인가요?	'언덕'	[CITE]
스태튼아일랜드 철도를 처음 운영한 것은 어디인가?	볼티모어 앤드 오하이오 철도	[WHERE]
복단 만딕은 자신의 부모님의 몇 번째 남자아이였나?	열두 번째	[WHO]
이경언의 선조는 누구인가?	조선왕조의 제3대 왕 태종	[WHO]
그림형제가 민담을 모으기 시작한 년도는?	1807년	[WHEN]
춘향전을 관람할 수 있었던 극장은 언제 열었나요?	1935년	[WHEN]
삼매봉 도서관은 원래 뭐라 불렸는가?	문예회관	[WHAT]
황남대총은 어느 시대의 릉인가?	삼국시대	[WHEN]
아트페어에서 컬렉터나 미술관계자들은 무엇을 하는가?	거래	[WHAT]
김익영이 국립박물관에서 일하기 전에 공부했던 곳은?	미국 뉴욕주립 알프레드 요업대학원	[WHERE]
항마촉지인의 손모양이 그려진 불화의 명칭은?	영산회상도	[WHAT]
여신의 전투와 군사적 관계를 중요시 한 사람들은?	그리스인들	[WHO]
도스토옙스키의 시력이 망가졌을 때 그는 어떤 방식으로 작품을 완성할 수 있었나?	도스토옙스키가 침대 누워 구술한 것을 아내 안나가 속기 하여	[HOW]
호 왕조는 멸망은 누구의 죽음에서 비롯됐는가?	명나라가 보낸 쩐 왕조의 후계자	[WHO]
담양 연동사지 지장보살입상이 만들어졌을것으로 추정되는 시기는?	고려 하대	[WHEN]
리가 직접 문화를 경험하며 연구했던 대상은?	자아	[WHO]
블라디미르 레닌이 자본주의 방식의 농업 구조가 과거 봉건적 농업 구조에서 발전된 모습이라는 것을 참고한 개념은?	마르크스주의의 지대 이론	[WHAT]
『성련선』 내용에 따르면, 대전시에서 UFO로 인식되어지는 물체는?	"""정체불명의 씨앗"""	[CITE]
이리퍼블릭의 시민들을 강화시키며 국가의 역량에 필요한 것은?	전쟁	[WHAT]
감각 뉴런이 감정을 격렬하게 느낄 때 이 뉴런은 어떻게 반응하는가?	글루타메이트를 시냅스로 방출	[HOW]
영어로 Presocratics란 뜻을 가진 낱말의 기원은?	독일의 고전 문헌학자 헤르만 딜스가 이들 철학자의 단편들을 한데 모아 엮은 책의 제목	[WHAT]
이정무의 아들이 이화여전의 이사에 앉은 것은 몇년도인가?	1936년	[WHEN]
에오독소스 아버지가 태어난 곳은 어디인가?	크니도스	[WHERE]
죽음에 대한 두려움을 이기고자 세르게이가 선택한 방법은?	단식	[WHAT]
선발 투수로서 첫 해에 젱킨스의 삼진 갯수는?	236개	[QUANTITY]
양옥환이 태진궁의 여관이 되었을 당시 그녀의 나이는?	22세	[QUANTITY]
게오르크 프리드리히의 아내는 언제 죽었는가?	1578년	[WHEN]
브랜던 슬레이가 세계 주니어 레슬링 선수권에 참가하여 5위의 성적을 거둔 해는?	1992년	[WHEN]
조선시대 최초로 신하들에게 공신녹권을 주었던 인물은?	태조 이성계	[WHO]
브나스크 백작령이 시칠리아의 토지였던 연도는?	1309년	[WHEN]
도쿠가와 요시노부는 통치권 반환을 몇 월에 신청했는가?	11월	[WHEN]
장군버거가 처음 출시된 해는?	1989년	[WHEN]
성하 마을과 주요 도로를 정비한 연도는?	1603년	[WHEN]
마틸데의 첫째 언니가 사망한 년도는?	1053	[WHEN]
나폴레옹 전쟁 기간 중 프랑스보다 더 많은 무기를 생산한 나라는?	영국	[WHERE]
마호라바에게 정신적 장애와 관련해 비난했던 국가는?	일본	[WHERE]
감무를 진나라로 보내지 말라고 초 회왕에게 말한 사람은?	범연	[WHO]
높이 5m의 장륙불상의 개수는?	2구	[QUANTITY]
창호지의 소재를 사용해서 만든 예술품은 무엇인가?	닥종이 인형	[WHAT]
14처가 있는 장소에서 기도를 할 수 없는 사람들은 어떤 방법으로 대사를 받을 수 있나?	축복된 십자가를 사용하여 기도함	[HOW]
농촌진흥운동은 누가 주도한 것인가?	총독부	[WHO]
중공군은 한국군 1개 대대가 오마치 고개에서 물러난 뒤 얼마 후에 공격을 퍼부었는가?	5일 후	[WHEN]
향교에 들어갈 수 있는 가장 낮은 신분은?	양민	[WHO]
해마다 식중독으로 목숨을 잃는 인구는?	약 700만 명	[QUANTITY]
여찬은 누구에게 죽임을 당하나?	여초	[WHO]
도쿄 도지사가 리우데자네이루의 시장에게서 건네 받은 것은?	올림픽 기	[WHAT]
네덜란드 작가들이 자국의 황금기를 비유한 말은?	"""헨드리크의 시기"""	[CITE]
방아깨비 수컷은 날면서 초당 약 몇 회의 날개짓을 하나?	약 30회	[QUANTITY]
조선무선강습소의 시초가 된 사람은?	조광운	[WHO]
사슴 동상이 위치한 동은?	서초동	[WHAT]
윌리엄 주니어가 윌리엄 대비슨을 위해 일하기 전에 학업에 열중한 곳은?	캠브릿지 피터하우스	[WHERE]
히스파니아 타라코넨시스가 세 개 속주로 나누어진 연도는?	293년	[WHEN]
폴이 어릴 적 성적으로 흥분을 느꼈던 대상은?	폴	[WHO]
완전히 고립된 물리적 계가 존재할 수 있는 곳은?	지구 밖의 우주	[WHERE]
우왕은 어디서 태어났는가?	능우의 어머니 집	[WHERE]
로마, 밀라노 관계 발전을 위해 여러 주교들이 참여한 회의는 어디에서 열렸나요?	라테라노 궁전	[WHERE]
한복의 속옷 중에서 가장 처음에 입는 것은?	다리속곳	[WHAT]
망코 잉카는 어떤자들에 의해 살해 당하나?	알마그로의 패잔병들	[WHAT]
왕망에 대한 계략을 꾸민 이들 중 주살되지 않은 이는 누구인가?	왕우	[WHO]
예르지 네이만, 이건 피어슨과 함께 일했던 사람은?	플로렌스 데이비드	[WHO]
황방촌 영정의 원본은 어디에 보관되어 있었나?	경북 상주의 옥동서원	[WHERE]
아픈 어머니를 위해 효자에게 고승이 처방해준 버섯은?	석이버섯	[WHO]
<거기 있나요>에서 인류진화과정을 나타내는 공간은?	양자역학적 공간	[WHAT]
에가와와 요미우리는 언제 계약을 파기했나?	12월 27일	[WHEN]
2005년까지 히페리온에 가장 근접해 사진을 찍은 탐사선은 무엇인가?	카시니 호	[WHAT]
마르텔리노를 죽이겠다고 협박한 시장의 국적은?	독일	[WHAT]
당사자는 항소심에 있어서 새로운 사실자료를 제출할 수 있다는 의미의 용어는?	'변론의 갱신권'	[CITE]
제닝스가 58살에 겪고 있던 질환은 무엇인가요?	수막염	[WHAT]
예수가 하나님을 아버지라고 부른 것은 무엇으로 인해 잉태되었기 때문인가?	성령	[WHAT]
자유민주주의에서 사람들 모두가 보장받아야 하는 것은?	자유	[WHAT]
박희양의 고조할아버지는 누구인가?	순조의 외할아버지인 박준원	[WHO]
25년 미만 복무한 군단병이 받았던 제일 큰 연봉은 얼마인가?	500 데나리우스	[QUANTITY]
모부투가 다당제의 허용을 공표한 연도는?	1990년	[WHEN]
하스타티들이 사용하지 않은 무기는?	창	[WHAT]
때때로 연극이 관객에게 무엇을 호소할려는지 알수 없는 이유는?	주제가 명확하지 않기 때문이다.	[WHY]
도쿄와 오사카를 연결하는 간설 철도로 주로 실어 나른 것은?	자재	[WHAT]
버몬트 공화국 헌법에 삼권 분립 원칙이 더해진 해는?	1793년	[WHEN]
튀르크인을 아나톨리아로 쫓아낸 병사들은 어느 지역에서 온 것인가?	카탈루냐	[WHERE]
아사이 쇼헤이가 친구들과 모이는 장소는?	켄고의 어머니가 경영하는 러브 호텔의 어느 룸.	[WHERE]
교황의 조정 하에 페라라에서 체결된 조약은 어느 해에 이루어졌는가?	1428년	[WHEN]
러블리스가 맥그래스를 공격한 이유는?	전차를 시험	[WHY]
파이완족이 일본 식민 통치 시기에 탄압받은 풍속은?	손에 문신을 하는 풍습	[WHAT]
믹 테일러는 어떤 밴드에서 기타를 연주하였나?	롤링 스톤스	[WHAT]
399년에 여광을 부르던 말은 무엇인가요?	태상황제	[WHAT]
여운형의 노비들이 자유를 찾았던 해는?	1908	[WHEN]
이동성이 만주로 이동한 해는?	1907년	[WHEN]
김정희가 청나라에 간 해는?	조선 순조 9년(1809)	[WHEN]
아메데오가 비스콘티 가와 맺은 조약에 포함된 항목은?	혼인 조항	[WHAT]
오리너구리와 눈 구조가 가장 비슷한 어류는 무엇인가요?	태평양먹장어(Eptatretus stoutii)	[WHAT]
구급차로 부상자가 이동하는 것을 막은 것은?	경찰	[WHAT]
칼스 보이스와 수잔 스토크스는 경제가 나아질수록 평화를 무너뜨릴 존재를 누구로 봤나?	파벌들	[WHO]
생도대의 2대대가 화랑리더스리그에 참여하는 요일은?	목요일	[WHEN]
19세기 말 러시아의 농민과 진보 귀족이 거부했던 농업 구조는 무엇인가?	자본주의적 농업 소유 구조	[WHAT]
보은 상무의 드래프트를 거절함으로써 군복무를 선택할 수 있도록 만든 사람은?	최유리	[WHO]
웰링턴 부대는 살라망카 전투에서 승리한 후 어디로 진출하였나요?	마드리드	[WHERE]
양명이 56세가 되기 전까지 열중했던 것은?	강학	[WHAT]
히포드롬에 남아있는 4개의 건축물 중 독일에서 가져온 것은?	분수대	[WHAT]
피커링이 최초로 업무를 시키기 위해 뽑은 여성의 이전 직업은?	하녀	[WHO]
네이든이 몰래 좋아하고 있었던 인물은 누구인가요?	닉	[WHO]
안성 정무공오정방고택에서 현재 남아있고 사랑채와 연결되어 있는 부분은?	안채	[WHAT]
1984년 올스타전에서 에가와 스구루의 8연속 탈삼진의 행진을 막은 사람은?	오이시 다이지로	[WHO]
박영효와 이규완의 나이 차이는?	한 살	[QUANTITY]
공식 발표를 참고하면, 조선철도국 축구단이 새로이 만들어졌던 년도는 언제인가?	1945년	[WHEN]
《내 어머니 사는 나라》에 등장하는 할아버지의 출신은?	북한	[WHERE]
가야파가 소집한 산헤드린 의회의 주요 의제는?	나사로의 부활	[WHAT]
라호르 조약은 제 1차 시크 전쟁에서 누가 패배한 후 체결되었나요?	시크족	[WHO]
전쟁 이후 노예인원의 변화에 따라 라티푼디움의 운영 구조는 어떤 방식으로 변화하였는가?	자유 소작제	[HOW]
유재홍 군단장에게 오마치 고개에서 철수할 것을 요청한 자는?	알몬드 소장	[WHO]
하라이 가즈야는 어디에서 셰이크를 활용해 포수를 플라이 아웃시켰나?	2005년의 2월 21일의 가고시마 스프링 캠프	[WHERE]
민간인을 상대로 무차별 공격을 벌인 군대는?	공화파 민병대	[WHAT]
아이톨리아 동맹 도시가 제2차 마케도니아 전쟁이 일어나자 옹호한 쪽은?	로마공화정	[WHAT]
소화관과 이어져있으며 허파의 역할을 맡는 장기는 무엇인가?	부레	[WHAT]
수잔 케인이 대만 고관을 소개해준 사람은?	켈리	[WHO]
카카포 보호를 위한 회복 계획을 추진한 해는?	1995년	[WHEN]
발리송이 미국에 알려진 시기는 언제인가?	2차 세계대전	[WHEN]
육군본부에서 국군에게 증원 부대를 투입해준 날짜는?	19일	[WHEN]
보헤미아 귀족들이 루돌프2세에게 받아낸 칙서를 통해 얻어낸 것은?	개신교의 자유	[WHAT]
이에몬에게 암살을 당한 인물의 딸 이름은 무엇인가요?	오이와	[WHAT]
허형이 장균의 소송을 담당할 당시 그의 관직은 무엇이었나?	계양태수	[WHAT]
제2차 세계대전 이후 잉글랜드어의 세계화에 큰 기여를 한 나라는?	미국	[WHERE]
불교사범학교의 원래 이름은 무엇이었나요?	명진학교	[WHERE]
충주 조동리유적의 신석기시대 문화층에서 다량 출토된 것은?	빗살무늬토기	[WHAT]
자유한국당이 크게 패배한 뒤 대표직을 내려놓은 인물은?	홍준표	[WHO]
어머니가 나가서 구하려한 것은?	치료비	[WHAT]
기존 한중 방면 사령관을 전사시킨 인물은?	황충	[WHO]
스타일과 여러가지 방면에서 성숙한 특징을 가진 소나타의 작곡가는?	베토벤	[WHO]
화이트베이스에게 직접 복수를 감행한 인물은?	이셀리나	[WHO]
유리 로디긴은 누구에게 골키퍼의 요령을 전수해주었나요?	자크하르	[WHO]
몇몇 금고를 제외하고는 어디에서나 만들 수 있는 새마을금고의 상품은 무엇인가?	상상모바일통장	[WHERE]
예측할 수 없는 대류의 움직임 때문에 발생하게 되는 것은?	난류	[WHAT]
고엽제 후유증 2세 환자로 최초 인정 판결을 받은 사람은?	베트남전에 참전한 장병의 자녀	[WHO]
갈릴레이가 금성의 위상 변화와 같은 과학적 증거를 기반으로 설파했던 이론은?	지동설	[WHAT]
주교가 주케토를 벗는 것은 무엇을 할 때인가?	영성체	[WHAT]
헬기의 말을 듣고 시그룬에게 무덤에 가 헬기를 만나라 한 인물은?	시그룬의 시녀	[WHO]
동남 36개의 섬들을 지배하고 있었던 인물은?	정성공	[WHO]
입구'에서 하차하는 승객에게 운송비를 받는 사람은 누구인가?	승강장의 관계자	[WHO]
간토 대지진 외에 사가미 해곡 지진에 해당되는 지진은?	겐로쿠 지진	[WHAT]
스칼라 레지아의 재건축이 시작된 해는?	1663년	[WHEN]
금산의 격전에서 상황을 반전시킨 인물은?	설인귀	[WHO]
버드 슈거맨 기념판은 어느 건물 쪽에 세워졌는가?	컴버랜드 테라스	[WHAT]
세포에서 핵, 엽록체 등을 포괄해 일컫는 말은?	세포 기관	[WHAT]
명륜당과 제사공간의 위치로 알 수 있는 배치 방식은?	전학후묘	[WHAT]
광전지는 무엇에 민감하게 반응하는 성질을 이용한 것인가?	빛	[WHAT]
수능에서 가장 많은 오류가 발생한 연도는?	2014	[WHEN]
에런 크루거는 위미르를 무엇이라 주장했나?	'유기생물의 기원과 접촉한 소녀'	[CITE]
원주군은 전국 8도 중 어느 곳에 속해 있는 지역인가?	강원도	[WHERE]
위층 기단에서는 어떤 모양의 8부중상을 볼 수 있는가?	모두 앉아 있는 모습	[WHAT]
진시황의 분서나 한자 변화로 잃어버린 유교 경전을 다시 구성하는데 사용된 학문은?	훈고학	[WHAT]
북한이 디지털 통신망 구축을 위해 계약을 맺은 곳은 어느 나라 회사인가?	이집트	[WHERE]
중국에서 미풍양속으로 여겨졌던 거주 풍습은?	호	[WHAT]
브레슬라우 전투 이후에 벌어진 전투는 무엇인가?	라이헨바르 전투	[WHAT]
존슨이 부상 이후 다시 경기에 참가할 때의 장타율은?	.376	[QUANTITY]
모란이 수놓아진 부분 중 녹색 연화문단으로 만들어진 것은 유물의 어느 부분인가?	가장자리	[WHAT]
조선민주주의인민공화국에서 현재 사용하고 있는 무역법의 마지막 수정 연도는?	2004년	[WHEN]
기갑 세력을 이용하여 호르티에게 항복을 받아낸 사람은 누구인가?	슈코르체니	[WHO]
잘못을 인정하지 않고 반발한 인물은 누구인가?	아버스놋	[WHO]
올림픽 태권도에서 최초의 승리번복이 일어난 연도는?	2008년	[WHEN]
사이리 투팍의 부친을 왕좌에 앉힌 장본인은 누구인가?	프란치스코 피사로	[WHO]
요한 바오로 2세의 아들을 죽인 악마 이름은?	벨라암	[WHAT]
퍼거슨 시의 시위대가 무력을 행사할만큼 격노한 이유는 무엇인가?	불기소 결정	[WHY]
재정위기를 타개하고자 루이 16세가 두번에 걸쳐 기용한 인물은?	네케르	[WHO]
피아노 협주곡 5번의 연주와 출판이 모두 이루어진 도시는 어디인가?	라이프치히	[WHERE]
탕헤르의 시가지에서 신시가를 조성하던 문화는?	유럽 문화	[WHAT]
초기 근대학교에서 국가주축으로 인격을 기르고자 체조시간에 시행한 것은?	군사훈련	[WHAT]
문천상의 사형 집행을 즉각 멈추라고 얘기한 인물은?	쿠빌라이 칸	[WHO]
EF13형 기관차는 전형적인 무슨 설계의 예시인가?	전시설계	[WHAT]
고티에가 영국으로 도망가기 전 머물렀던 곳은?	칼레	[WHERE]
2013년에 이진한 서울중앙지검 제2차장검사가 받은 혐의는?	성추행	[WHAT]
맥거번이 시카고에서 개최된 민주당 전당 대회에 참여하려 하기 전에 살해당한 인물은?	로버트 케네디 상원	[WHO]
재야 및 운동권자들이 늦봄, 초여름 즈음에 벌인 시위장소에서 개최 예정이었던 행사는?	신한민주당 개헌추진위원회 인천 및 경기지부 결성대회	[WHAT]
워터게이트 당시 특별검사를 면직시킨 인물은 어떤 결과를 맞이하였나?	하야	[WHAT]
진우량의 자녀 이름은?	진리(陳理)	[WHO]
박근혜 대통령이 남북교류협력사무소 설치를 제의한 것은 몇 월인가?	2014년 3월	[WHEN]
세르비아 몬테네그로의 전 국호는?	신유고슬라비아	[WHAT]
"""텍사스의 아버지""로 불리던 엠프레사리오의 아버지 이름은 무엇인가요?"	모세 오스틴	[WHAT]
일반인은 앉을 수 없는 벤치가 있는 공간은?	하원 회의장	[WHAT]
나치가 본인의 정책 중 경제 분야를 맡긴 사람은?	얄마르 샤흐트	[WHO]
공박에서 2008년 4월에 새로 선보인 캐릭터가 수행하기에 적절한 포지션은?	공격수	[WHAT]
한국에서는 관심을 받지 못했지만 일본에서 붐을 일으킨 음악의 장르는?	뽕짝	[WHAT]
릭단이 1620년 무력으로 중국 명나라로 부터 받아낸 조공의 금액은 얼마인가?	40,000냥	[QUANTITY]
정치가 이전에 로마 축제를 담당했던 사람은?	조영관	[WHO]
댓글에 의해 스레드 위치가 바뀌는 게시판이 시작되었던 날짜는?	9월 6일	[WHEN]
난방 에너지원을 전기로 통합하는 것을 무엇이라고 부르나요?	‘섹터간 융합’	[CITE]
“마님이 된 하녀”가 나머지 부분과 분리되기전 작품의 이름은?	“자랑스런 죄수”	[CITE]
외계인들로 이루어진 제국을 이끄는 사람은?	성왕 바주	[WHO]
인터랙션 디자인은 무엇의 등장으로 빠르게 발전되었나요?	그래픽 사용자 인터페이스(GUI)	[WHAT]
캐니언이 발견한 버킷리스트는 누가 쓴 것이었나요?	빌리	[WHO]
한국에서 처음으로 여자 피겨 선수권 대회 1등을 배출한 해는?	1948년	[WHEN]
우르바노 5세는 1370년에 어디로 가기 위해 코르네토에서 배를 탔나요?	프랑스	[WHERE]
짐보의 이야기 중 베트콩과의 전쟁에 같이 참여한 인물은?	네드	[WHO]
《제일하우스 록》은 어느 나라의 영화인가요?	미국	[WHERE]
글리세린과 프탈산의 화합물은?	글리프탈수지	[WHAT]
트램펄린의 개발은 누구의 행위에서 아이디어를 얻었는가?	공중곡예사	[WHO]
유일하게 병동 현장을 본 사람은?	의사의 아내	[WHO]
빌의 새아버지의 이름은?	로저 클린턴	[WHO]
손환을 구하려다가 적의 기습을 당하는 장수는?	최우	[WHAT]
이집트를 구원하기 위해 로마에서 보낸 사람은?	가이우스 포필리우스 라이나스	[WHO]
리튬 전지가 여러 분야에서 무엇을 대체하여 쓰일 수 있는가?	알칼리 전지	[WHAT]
페가수스 다리 공격 시 이동수단은?	글라이더	[WHERE]
오리너구리가 전기를 가장 잘 느끼는 부위는?	부리	[WHAT]
브라질의 일반 시민들은 대체로 어떤 직업을 가지고 있나?	농업노동자	[WHAT]
해먼드 부자 구금의 계기가 된 사건은 언제 일어났나요?	2012년	[WHY]
온센타마고에서 굳는 부분은 어떤 성분을 지니고 있는가?	철분	[WHAT]
1944년에 소드 해변은 누가 차지하고 있었나요?	나치 독일	[WHO]
선수와 관중 사이에 다툼이 벌어졌던 경기 날짜는?	3월 18일	[WHEN]
존스가 최정예 대대를 파견해서 돕고자 한 부대는?	주벌 얼리의 보병부대	[WHAT]
복할배는 누구의 배반으로 인해 사망하게 되나요?	프로야구단 꼬물꼬물스	[WHO]
조선인민당이 보수층을 위해 사용한 문양은?	태극	[WHAT]
1560년 이전 스코틀랜드 교회의 소속은?	로마 가톨릭	[WHAT]
그림에서 귀걸이와 팔찌가 장식된 인물은?	지장보살	[WHO]
피렌체 화파에 영향을 끼친 사람은?	조토 디 본도네	[WHO]
일본공산당에 불만을 품은 과격파 학생당원들이 차후에 만든 단체는?	공산주의자동맹	[WHAT]
비오 11세의 선임자는?	베네딕토 15세	[WHO]
이자나미의 죽음이 나와있는 책은?	고사기	[WHAT]
갈라티 수도원이 세계 문화 유산으로 선정된 해는?	1994	[WHEN]
중학부 종목에서 3:2로 패배하여 우승하지 못한 학교는?	중동학교	[WHERE]
아비코 역 안내 표기가 히라가나인 것은 누구를 배려함인가?	난독인	[WHO]
튀코와 결투하면서 그의 코 일부를 잘랐던 인물은?	맨더루프 파스버그	[WHO]
상습적으로 윤락행위를 저지르는 자를 부르는 말은 무엇인가요?	요보호자	[WHAT]
튜더 왕가의 정통성에 해를 가했던 사람들은 언제 죽음을 당하였나요?	튜더 왕조 시대	[WHEN]
보통 긴팔원숭이들의 암수 구분은 무엇으로 알 수 있나요?	털 색깔	[WHAT]
조지아인과 오세트인이 화합을 이루웠던 때는 언제인가?	소비에트 시대	[WHEN]
송일국의 매니저가 김을동의 의원실 인턴 업무를 병행했던 연도는?	2008년	[WHEN]
크르팔레크가 세계 선수권에서 5위를 한 년도는?	2015년	[WHEN]
1990년 대통령표창 애족장을 추서받은 사람의 본관은?	남평	[WHO]
2005년의 조사에서 밝힌 아루바에서 살고 있는 민족의 수는?	92개	[QUANTITY]
필리포스 2세의 통치 기간에 이익을 위해 만든 것은?	아이톨리아 동맹	[WHAT]
두 개의 지역으로 줄어든 후에 킬리키아의 명칭은 무엇으로 변경되었나?	시리아킬리키아 포에니케 (Syria-Cilicia Phoenice)	[WHAT]
제2차 야마모토 내각이 국가가 직접 조선인을 감찰할 것이니 개인이 사적 제재를 하지 말라고 공표한 것은?	내각고유 제2호(조선인에 대한 박해와 관련된 사고 건)	[WHAT]
장면이 총리가 되는 것을 반대한 인물은?	김두한	[WHO]
블룸필드가 타갈로그어를 연구할 당시 다니고 있던 직장은?	일리노이 대학교	[WHAT]
로디니아가 갈라지기 시작한 시기는?	6억 년 전 경	[WHEN]
벨라루스 공화국은 몇 년도부터 특별 참가국 자격으로 유럽 평의회 의원 회의에 참석하였나?	1992년	[WHEN]
4·19 혁명이 성공한 이후, 김영훈이 사직한 직분은?	교육감직	[WHO]
튀코가 출판한 항성목록의 갯수는 이후에 몇 개가 되었나요?	1000개	[QUANTITY]
미에빌의 작품속에서 보이는 등장인물이나 작품경향에 영향을 준 게임의 종류는?	롤플레잉 게임	[WHAT]
《닥터 후》에서 정기 배역으로 출연을 맡은 인물은?	빌리 파이퍼	[WHO]
남상철의 아버지는 언제 살아남았나요?	병인박해	[WHEN]
양성 통제는 무엇을 판가름 하기 위해 흔하게 쓰이는가?	테스트 유효성	[WHAT]
빔비사라의 아들이며 앙가를 다스린 사람은 누구인가?	아자타샤트루	[WHO]
임진왜란 당시, 황석산성에서 두 아들과 함께 죽음을 맞이한 인물은?	안음현감 곽준	[WHO]
콜레라의 원인을 오염된 물이라고 하는 주장을 일축한 것은 누구인가?	검증위원회	[WHO]
방송통신심의위원회와 인터넷 방송국에게 방송인 관리를 더 철저히 해야한다고 말한 사람은 누구인가?	국민의당 국회의원 최명길	[WHO]
마르첼로 1세가 로마 주교 자리에 앉게 된 해는?	308년	[WHEN]
하워드 마셜의 재산 상속을 위해 안나 니콜 스미스가 법정 소송을 벌인 기간은?	12년	[WHEN]
1992년에 수립된 알바니아 민주당 정권의 리더는 누구였나요?	살리 베리샤	[WHO]
셰익스피어가 창작한 실수 연발에서 다뤄지고 있는 이야기의 소재는?	가족의 이별과 재회	[WHAT]
반클리프 아펠의 회고전은 어느 계절에 열렸나요?	여름	[WHEN]
광무개혁은 어떤 산업의 진흥을 위해 실시된 정책이었나요?	상공업	[WHAT]
조선후기 불상들에게서 흔이 볼 수 있는 의복의 종류은?	법의	[WHAT]
그리폰이 반란을 일으켰던 인물은 아버지가 죽기 전 무엇을 받았나요?	네우스트리아·부르고뉴·프로방스	[WHAT]
과실인 경우에도 처벌받을 수 있음이 명시된 규칙은?	형법총칙	[WHAT]
바그라트의 아버지가 타오와 파시아네를 점령한 년도는?	1014년	[WHEN]
알바왕국의 계보가 있는 부록에서 가장 마지막에 죽은 인물은?	크란돔너 막 에크다크다	[WHO]
실제로 중화민국 국민임을 입증하려면 어느 지역에 살아야하나요?	타이완 지구	[WHERE]
요한 1세에 대해 의심을 품고 그를 라벤나로 부른 사람은?	테오도릭 대왕	[WHO]
갑관요가 상서에게 잘못을 고한 대상은?	위위	[WHO]
강유가 진태와 곽회에 의해 도주하게 되는 회차는?	제107회	[QUANTITY]
기관, 기업소 협동단체에서 팔아줄 수 있는 8.3 인민소비품의 양은 어느 정도인가?	30% 범위	[QUANTITY]
창녕 포교당 법당의 목조석가여래좌상이 처음 봉안된 곳은?	창녕 관룡사	[WHERE]
기영재를 살해한 인물은 누구인가?	검은 세력에 포섭된 경찰	[WHO]
곽상훈이 내각 책임제 개헌을 제안했다가 무시 당할 당시의 대통령은 누구인가?	이 박사	[WHO]
대류권에서 바람의 세기가 가장 큰 부분은 어디인가?	권계면 부근	[WHERE]
망각의 지팡이를 만든 사람은 지금 어디 살고 있나?	갈라바 성	[WHERE]
20세기 초반에 미치류의 척추뼈를 크기와 모양으로 구분했던 방식을 무엇이라고 하는가?	분류학적 접근	[WHAT]
마이크로키니의 제작 계기가 된 해변은?	베니스의 해변	[WHY]
오현주의 횡령을 주장한 사람은?	김마리아	[WHO]
트레혼데아르도스 공군기지의 전투기를 볼 수 있는 곳은?	마드리드 바하라스 공항	[WHERE]
투스카라 족은 어떤 사건을 계기로 펜실베니아 또는 뉴욕으로 거처를 옮겼나?	18세기 투스카로라 전쟁	[WHY]
코르부트가 선수들 중 처음이자 마지막으로 평균대 경연에서 선보인 기술은?	뒤로 재주넘기	[WHAT]
비가 내린 뒤 밤에 결혼비행을 하는 개체는 무엇인가?	흰개미	[WHAT]
레오폴도가 사제가 된 연령은?	24세	[QUANTITY]
충실하지 않은 선거인을 2008년까지 구별해낼 수 없었던 지역은?	미네소타 주	[WHERE]
건반을 누를 때 잭의 움직임에 따라 현에 닿는 것은?	플렉트럼	[WHAT]
새누리당이 집정 여당으로 자리매김 할 수 있는 발판이 되었던 인물은?	이명박	[WHO]
호꾸이리의 아들 이름은?	호한뜨엉	[WHO]
펠라지오는 누구와 함께 콘스탄티노폴리스로 갔나요?	교황 아가피토 1세	[WHO]
샤 슈자가 자신의 왕위를 물려줄 사람은?	자인 알아비딘(Zain Al-Abidin)	[WHO]
디트릭슨은 네프와 무슨 보험을 계약 중이었나?	자동차 보험	[WHAT]
12월 14일 전쟁에서 프랑스 장교는 몇명이 죽음을 당하였나요?	3명	[QUANTITY]
크릭이 과학과 종교의 연결성을 언급했던 도서는?	〈얼마나 미친 추구인가〉	[CITE]
뮤 중간자를 일컫는 또 다른 명칭은?	뮤온	[WHAT]
카이사리온이 옥타비아누스를 피해 도망친 곳은?	홍해의 항구	[WHERE]
풍부한 식감으로 인해 부첼라토가 지니게 된 전통적인 의미는 무엇인가?	가족의 화합	[WHAT]
코핀을 볼 수 있는 동굴은?	소천굴	[WHAT]
해왕성 동기 궤도 안쪽에 있는 위성들을 무엇이라고 부르는가?	내위성	[WHAT]
자유 경쟁과 상호 의존을 함께 유발하는 이념은?	자유주의	[WHAT]
유럽과 아메리카 사회가 제국주의로 가는 과정에 있다는 주장에 이이를 제기한 집단은?	멘셰비키	[WHAT]
조선공업은 어떤 공업으로 분류되는가?	종합공업	[WHAT]
샤푸르 2세가 죽은 뒤 조로아스터교의 사제들과 협력하여 왕권을 약화시킨 계급은?	봉건귀족	[WHO]
자유 연상을 창시한 인물이 그만둔 치료 방법은?	최면술	[WHAT]
경찰이 병력 배치등을 이유로 참여 인원을 추정하는데 근거로 삼는 것은?	페르미 추정법	[WHY]
대한민국이 5개국을 꺾고 디비전 1A로 승급될 수 있었던 해는?	2012	[WHEN]
전국의 사원이나 향교를 탐방할 수 있는 1박 2일 여행 프로그램은?	1박2일 인문여행	[WHAT]
예르지 네이만과 피어슨의 직장은 어디였나?	유니버시티 칼리지 런던	[WHERE]
마드리드 시가 관리하기 전에 10호선을 관리하던 것은 어디인가?	FEVE	[WHERE]
사마귀가 사냥감을 공격하는 모습을 참고하여 만든 중국의 놀이는 무엇인가?	당랑권	[WHAT]
프레몽트레회에 들어오길 원했으나 노르베르토가 평신도로 있을 것을 권한 사람은?	테오발드 2세 백작	[WHO]
마가다와 다이아몬드 채굴권을 협상한 나라는 어디인가요?	밧지 공화국	[WHERE]
성매매법이 실시된 연도는?	2004년	[WHEN]
트램펄린 회사를 설립한 사람은?	조지 닐센	[WHO]
라틴 아메리카나 스페인에서 식전주와 곁들여져 나오는 요리는?	타파스	[WHAT]
경찰이 원영의 시신을 찾기 위해 수색 작업을 실시한 날짜는 언제인가요?	3월 10일	[WHEN]
비자연적으로 면역을 얻는 경우에 해당하는 방법은?	백신 접종	[WHAT]
카롤의 결혼 결정에 입김을 불어넣은 사람은?	마리아 왕비	[WHO]
작문시험과 성적을 통해 로리뷰 편집 위원을 뽑는 때는 언제인가?	1학년 기말고사 후	[WHEN]
《트래버스 드 수 조약》과 《멘도타 조약》을 체결하고 사냥터를 미국에 양도한 계약 당사자는?	미네소타 다코타 수 족	[WHO]
아이라 시와 가고시마 시가 구분되는 곳에 있는 것은?	무레가오카 연산	[WHAT]
아폴론에게 예언을 주관하는 힘을 준 이는?	제우스	[WHO]
피실험자들의 공통적인 특성은?	주식과 거리가 먼	[WHAT]
오생원의 아들이 정사를 나누던 사람은 누구인가?	추월	[WHO]
피터와 함께 하이든의 무덤을 도굴한 인물은?	로젠바움	[WHO]
오다 도시히로가 슈고다이가 된 후 다스린 지역은?	오와리 북부의 4개군	[WHERE]
독일인으로서 최초로 교황이 된 자의 사망일은?	998년 2월 18일	[WHEN]
로페스 데 레가스미는 비사야 제도의 북쪽 지역을 조사하라고 몇 사람을 보냈나?	두 사람	[QUANTITY]
집권 후 지구 과학 분야의 지원에 몹시 부정적 태도를 취한 사람은?	도널드 트럼프	[WHO]
아트 앤드 크래프트 운동을 이끈 사람은?	윌리엄 모리스	[WHO]
《로마제국 쇠망사》의 시기 구분 중 서로마제국이 첫번째로 존속했던 시기는 언제인가?	제1기	[WHEN]
타지마할은 산성비로 어떤 피해를 입었는가?	백색 대리석이 점차 황갈색으로 변해가고 있는 것	[WHAT]
3회에서 히코노에게 홈런을 허용한 상대팀 투수는?	니시자키 유키히로	[WHO]
루빈시테인의 스승은 누구인가요?	알렉산드르	[WHO]
<아바타>는 언제 처음으로 상영되었나?	2009년 12월 18일	[WHEN]
신라가 불을 일으킬 수 있는 신체 부위는?	발	[WHAT]
돈 칭자오를 때렸으며, 그가 원한을 품게 한 인물은?	루피의 할아버지	[WHO]
콘늘라를 강제로 돌려 보내려 한 사람은?	코날 케르나크	[WHO]
핀과 함께 사막에서 오토바이를 탄 인물은?	캐니언	[WHO]
베토벤은 어떤 곡을 피아노로 편곡하였는가?	프로메테우스의 창조물, 작품번호 43	[WHAT]
루티프 아피푸가 소속된 집단은?	검은 9월단	[WHAT]
알프레드가 아버지를 여읜 것은 몇 년도인가?	1826년	[WHEN]
단일불포화 지방 위주의 식단일 경우 인슐린 자항성의 발생률이 어떻게 되는가?	감소	[WHAT]
말레이시아어와 매우 유사하며 말레이어라고 칭하는 게 맞다는 주장이 있는 언어는?	인도네시아어	[WHAT]
용수당을 만들기 위해서는 엿당 포화용액을 끓인 후 몇 분 정도 식혀야 하는가?	10분	[WHEN]
점토로 제작된 원통형 화덕에 숯불을 놔두어 고온으로 가열하는 오븐은?	탄두르 오븐	[WHAT]
승강장이 지하 2층에 있는 지하철역은?	마루노우치선	[WHAT]
텔레비전 음악회에서 가수 김연자가 부른 노래는?	〈림진강〉	[CITE]
바로 가기 아이콘을 실행할 수 있게 하는 프로그램은 무엇인가?	프로그램 관리자	[WHAT]
사르트르는 개인이 어떤 존재라고 생각했는가?	자유 의지를 실현하는 주체	[WHAT]
대한민국 행정심판법 제3조 제 1항의 근간이 되는 방침은 무엇인가?	개괄주의	[WHAT]
케플러는 누구의 화성 관측 자료를 통해 행성 운행표를 만들었나요?	티코 브라헤	[WHO]
태양계 거대 기체 행성의 주요 구성 요소들은 무엇인가요?	수소와 헬륨	[WHAT]
뉴욕주의 주지사로서 톰킨스가 폐지하고자 노력한 제도는?	노예제	[WHAT]
다카기 모리미치가 주니치의 감독직에서 사임한 해는?	1995년	[WHEN]
익명조합원은 어떠한 상황에 익명조합을 활용하여 돈을 벌 수 있는가?	영업자가 될 수 없는 경우	[WHAT]
아델리펭귄 새끼들이 먹이를 달라고 칭얼거릴 때 무엇과 유사한 소리를 내는가?	휘파람	[WHAT]
2007년 IAU에서 외계 행성과 갈색왜성을 구분하는 척도로 삼자고 제시한 것은?	질량	[WHAT]
양운에 의해 역모 계획이 들통난 사람은?	곽우	[WHO]
쯔웨는 SM엔터테인먼트에 누구의 영화 출연을 요구했나요?	크리스	[WHO]
형사소송법 제361조의4 제1항에서 법적으로 보호하는 사람은?	피고인	[WHO]
이탈리아 AC 밀란에 의해 3년 연달아 컵위너스컵을 달성하지 못한 국가는?	독일팀	[WHERE]
헤위에르달이 실험을 한 이후에 이야기를 나눈 상대는?	이스터 섬의 주민	[WHO]
이용순이 서재필의 시신을 뒷수습할 당시 서명원이 머무르던 국가는?	북한	[WHERE]
코시모는 누구로부터 교육을 받았나?	신학자 반디넬리	[WHO]
이화곡 가루를 물과 쌀에 넣으면 무엇이 시작되나요?	발효	[WHAT]
이사회에서는 회의를 한 해에 적어도 몇 개 진행하나?	2개	[QUANTITY]
콘스탄티네 2세에 이어 왕위를 계승한 인물은 언제까지 군림하였나요?	1525년까지	[WHEN]
견갑골의 움직임에 집중한 훈련의 효과를 본 구종은?	직구	[WHAT]
호라티우스가 아테네로 공부하러 가게되었던 해는?	기원전 45년	[WHEN]
마이클 스펜스가 철학을 공부한 대학교는?	프린스턴 대학교	[WHAT]
조프루아가 여러 학자들이 발표한 동물 구조의 유사성 개념을 참고해 만든 논문은?	<유추론자의 이론에 대하여>	[CITE]
1963년 제 5대 대통령 선거 후보로 확정된 인물은?	윤보선	[WHO]
《애시스 투 애시스》에서 앨릭스 드레이크를 총으로 쏜 인물은?	아서 레이튼	[WHO]
역의 동쪽 일부에서 토지 구획 정리 사업을 주관하는 도시는?	오사카시	[WHERE]
머리광배에 특이하게 불꽃무늬나 연꽃무늬를 각인하는 특징을 가진 나라는?	백제	[WHERE]
인터넷과 휴대전화의 보급 전 주로 사용되던 물리적 매체는?	유선전화	[WHAT]
술을 계속 찾도록 유도하며 알코올의 영향을 받는 것은?	오피 오이드	[WHAT]
크로마토 그래피 카트리지가 한 번에 사용 가능한 샘플의 수는?	한 샘플	[QUANTITY]
학자들이 슬라브조어를 위해 사용한 외국의 언어는 무엇인가요?	인도유럽어족 언어	[WHAT]
아리스타르코스가 처음으로 지동설을 이야기했지만 이를 반박한 인물은?	히파르코스	[WHO]
1897년 민영환이 영국공사로 갔을 당시 영국은 누가 다스리고 있었나요?	영국 여왕 빅토리아	[WHO]
타스만 호수에서 흐르는 물은 타스 강을 거쳐 어느 호수로 흘러가나?	푸카키 호수	[WHAT]
경찰관은 김씨를 누구라고 생각했는가?	시위대 중 한 명	[WHO]
메데이아가 화가 난 이유는 무엇인가?	이아손이 코린토스의 공주 글라우케와 결혼	[WHY]
히키코모리에 대한 별 관심을 두지 않았던 때는?	2000년대	[WHEN]
포도주 블라인드 테스트를 소재로 만든 영화의 제목은?	‘와인 미라클’	[CITE]
매니저가 사실이 아닌 내용이라며 해명서를 발표했던 방송은 무엇인가?	KBS 시사기획 쌈	[WHAT]
유럽 연합군 최고사령부가 출범한 것은 몇년도인가?	1951년	[WHEN]
이반 T.굿맨 다음으로 샌피드로 산 미라를 보유한 사람은?	리오너드 워들러	[WHO]
2002년 9월 22일에 시행된 독일 총선거에서 뽑고자 했던 연방의회 의원 수는?	603	[QUANTITY]
브루노와 부팔마코가 칼란드리노의 여정에 함께한 이유는?	놀리기 위해	[WHY]
경성일보에 담화문을 발표한 자는 종교계 사람들을 무엇이라고 나무랐는가?	음모꾼	[WHAT]
페르디난도 2세는 언제 사망했나?	1859년 2월 3일	[WHEN]
가미요시다의 국도 139호 인근에 많아진 것은 무엇인가?	상점	[WHAT]
제2대 주일 미국 공사가 일본에서 세운 가장 큰 업적은 무엇인가?	시모노세키 전쟁 이후 진행된 협상	[WHAT]
한국 대 멕시코 경기에서 선제골을 넣은 쪽은?	한국	[WHAT]
시에라 네바다 산맥에서 할 수 있는 스포츠는?	스키	[WHAT]
진화론을 다룬 학파 중 기형의 역할을 중시한 학파는?	멘델학파	[WHAT]
오래된 족자는 어디에 진열되어 있었나?	메밀 국수 가게의 쇼윈도	[WHERE]
나기브에게 가택연금 처분을 내린 자는?	나세르	[WHO]
저고리의 길이가 짧아진 시기는 언제부터인가?	고려 말	[WHEN]
스페인의 기독교인들과 성관계를 하게 될 시 위험해지는 사람들은?	무데하르 여성들	[WHO]
케냐를 부패하게 만들고 본인도 국가의 대지주로 만든 케냐타의 정책은?	대지 정책	[WHAT]
맥다월의 군대가 후방에 남아서 방어해야 하는 도시는?	워싱턴	[WHERE]
몽칼름과 보드레이유가 지휘 문제로 서로 갈등하기 시작한 것은 몇 년인가?	1756년	[WHEN]
1987년 일본 시리즈 우승팀을 지도한 감독은?	모리 마사아키 감독	[WHO]
매그니토가 나온 장면의 대부분을 연기한 배우는?	이언 매켈런	[WHO]
록키에게 재시합을 신청한 사람은?	아폴로 크리드	[WHO]
카리용 전투에서 영국 육군이 조지 호수 해안에 상륙했을 때, 그곳에 방치되어 있던 물자와 무기는 어느 나라 군대의 것이었나?	프랑스	[WHERE]
10월 3일까지 오키나와 방면에서 유일하게 공격받은 곳은?	오키다이토 섬	[WHERE]
포켓몬 바크 경기가 진행되는 장소는?	크라운 시티	[WHERE]
거북산이라 불리는 산의 명칭은?	범방산	[WHAT]
미주리 타협을 무효로 하는 법은?	캔자스-네브래스카 법령	[WHAT]
랑페르 드 브르트니에르가 1858년에 다녔던 학교는?	생 쉴피스 신학교	[WHERE]
에우포르보스와 아폴론이 함께 공격했던 인물은?	파트로클로스	[WHO]
동탑은 탑신 몇 층으로 구성되어있나?	3층	[QUANTITY]
2018년 당시 보이저호의 위치는?	화성	[WHERE]
사수도의 해안선은 대부분 무엇으로 구성되어 있나요?	암벽	[WHAT]
장 전 총리가 한 행동을 두둔해준 사람의 이름은?	김수환	[WHO]
냉전 이후 여러 분야에서 상대적 발전을 지속한 시대를 일컫는 용어는?	"""새로운 평화(New Peace)"""	[CITE]
동투르키스탄을 식민지로 삼아야 한다고 주장한 사람은?	게라심 콜라파코프스키	[WHO]
광해군이 나라를 통치할 당시에 주도권을 가지고 있던 파는?	북인	[WHAT]
이호민이 과거시험에 합격한 것은 몇년도인가?	1801	[WHEN]
주민들의 대피를 도왔던 사람의 이름은 무엇인가요?	조영달	[WHAT]
알하킴이 후세인의 정치 권력을 없애기 위해 만든 조직의 이름은?	이라크 이슬람혁명최고위원회(SCIRI)	[WHAT]
박재완이 금자탑을 세운 해는?	2015년	[WHEN]
도스토옙스키는 젊었을 때 어떤 사상을 추구하는 정치 클럽에 참여하였나?	공상적 사회주의	[WHAT]
순무 제도가 생긴 것은 언제인가?	영락제 시기	[WHEN]
미국으로 이민 온 사람들은 누구로부터 돈을 차용할 수 있었나?	중개인	[WHO]
종교적 목적으로 파리 대학교에 교황이 세운 교육 기관은?	동방 언어 학원	[WHAT]
신자가 편의점에서 잡은 남자는 몸 어디에 문신이 있나?	팔목	[WHERE]
뮤지얼보다 더 높은 점수로 경기를 그만 둔 인물은?	토니 그윈	[WHO]
《나니아 연대기》시리즈 중 시간 설정이 가장 먼저인 작품의 이름은?	《마법사의 조카》	[CITE]
삼손의 약혼녀였던 사람의 아버지 이름은?	투발	[WHO]
김원치 검사와 이흥구가 재회하여 이야기를 나누었던 시간은?	20여분	[WHEN]
일본인들에게 송도고보는 일본의 어느 학교보다 더 크다고 소문났나?	와세다 대학	[WHERE]
황국의용군의 지도자는?	오카자키	[WHO]
나라에서 군인들을 뽑아 만든 군대를 통솔하는 우두머리는 누구인가?	군의(軍毅)	[WHO]
사이버펑크에 주로 등장하는 시간적 공간적 배경은?	가까운 미래의 지구	[WHAT]
피부세포를 다른 조직으로 전환시키는 기술보다 안전성 측면이 취약한 기술은 무엇인가?	유전적 리프로그래밍	[WHAT]
미하일 무루초스는 태권도가 정식 종목이 된 올림픽에 참가하기 위해 어디에서 예선전을 치뤘는가?	스톡홀름	[WHERE]
인류의 발전에 있어, 인류의 머리가 커지기 전에 일어난 일은 무엇인가?	직립보행	[WHAT]
타란티노의 영화에서 자주 들을 수 있는 음악 장르는?	고전 팝	[WHAT]
훗날 나오마사가 된 인물이 당주가 되었을 당시 나이는?	15세	[QUANTITY]
불경에 악평을 쏟아 궁예가 직접 살해한 승려는?	석총(釋總)	[WHO]
보살상의 최상단에는 무엇이 그려져있는가?	흰 광선	[WHAT]
윤치호가 일부 독립운동 지도자들로부터 비난 받았던 일기의 내용은?	“나는 국경일에 일장기를 게양하는 것을 반대하지 않는다. 왜냐하면 우리가 일본의 통치하에 있는 한 우리는 그 통치의 명령에 복종해야 하기 때문이다.”	[CITE]
보좌관이 아닌데 보좌관으로 불리는 요원들의 별명은?	새끼 보좌관	[WHAT]
오다와라의 다수의 건물이 붕괴된 원인은?	간토 대지진	[WHY]
사회적으로 은둔하며 외톨이 생활을 하는 사람을 부르는 명칭은?	히키코모리	[WHAT]
닉슨 행정부가 베트남 전쟁에서 옹호했던 편은 어디인가?	남베트남	[WHERE]
대부분의 마약은 멕시코를 거쳐 어디로 운반되었는가?	미국	[WHERE]
이민곤에게 유배령을 거둬들이고 벼슬과 영정을 내린 왕은?	영조	[WHO]
트리에르바일레르가 지속적으로 일을 해야 하는 이유는 무엇인가?	전 남편과의 사이에서 낳은 자녀들을 부양하기 위해	[WHY]
마라도나는 어느 나라 선수인가?	아르헨티나	[WHO]
미국이 베트남에서 철군한 이후 사이공을 장악한 세력은?	북베트남	[WHAT]
마리가 사망할 당시 그녀의 나이는?	65살	[QUANTITY]
지방지 중 전국지와 크게 다를 것이 없는 것은?	블록지	[WHAT]
소영의 나이는 몇 살인가?	18살	[WHO]
간결과의 토론 후 진중권은 누구로부터 토론을 제안받았는가?	변희재	[WHO]
천장욱이 귀국 후 처음으로 군수직을 맡은 곳은 어디인가?	전북 임실군	[WHERE]
미국의 고용시장은 어느나라로 생산 라인이 크게 옮겨지며 감소하게 되었나?	중국	[WHAT]
아타속이 먹는 균이 길러지는 곳은?	중형 일개미들이 가져온 잎	[WHERE]
민영익의 한쪽 눈을 찔러 기습공격을 감행한 인물은?	서재창	[WHO]
신식 전술 중 보병의 진군에 방해가 된 것은?	철조망	[WHAT]
일 년전쟁에서 결과적으로 이긴 부대는?	지구연방군	[WHAT]
해방 정국에서 각 정치세력이 유일하게 합의를 이룬 해는 언제인가?	1946년	[WHEN]
중세시대에 가장 이름을 날렸던 타이빈성 출신 문학가는?	레꾸이돈	[WHO]
시간과 공간이 서로 영향을 주고 받는다고 주장한 학자는?	아인슈타인	[WHO]
일반적인 성작은 무엇으로 만들어지나요?	값비싼 합금	[WHAT]
형재 프랭크퍼트 지역에 처음 발을 딛은 백인은?	크리스토퍼 기스트	[WHO]
자유심증주의가 법관의 판단을 절대적으로 신뢰한다는 것이 드러나는 조항은?	308조	[QUANTITY]
서복영의 남편이 태어난 도시는?	전라남도 고흥군	[WHERE]
치아표면을 상하게 하는 산은 세균이 무엇을 분해시키면서 발생하는가?	당	[WHAT]
크렘린 궁 석벽의 현재 용도는?	혁명영웅들의 묘지	[WHAT]
댈러스 이전에 부통령직 지위를 제안받은 인물은 누구인가요?	사일러스 라이트	[WHO]
아일랜드 명칭의 유래가 된 사람의 아버지는?	에른마스	[WHO]
어떤 성분을 많이 넣어야 도자기의 처음 성형했을 때와 구워 냈을때의 형태가 별로 달라지지 않는가?	석영질의 흙	[WHAT]
유란시아의 원본은 어떤 언어를 사용하였나?	영어	[WHAT]
공장들이 방향을 수익 중심으로 잡게한 제도는?	독립 채산제	[WHAT]
청자 상감국화모란유로죽문 매병에서 꽃봉오리 같은 부분은 어떤 모양으로 다듬어져있나요?	‘∧’ 모양	[CITE]
한나라당이 댓글 관리를 처음 시작한 해는?	2006년	[WHEN]
불암산 호랑이 유격대의 마지막 유격전은 어떤 군대의 수송대를 공격하는 작전이었나요?	북한군	[WHAT]
일본 오야마 역과 신마에바시 역을 잇는 여객철도 노선의 개통 당시 본래의 기능은 무엇이었나?	화물 철도	[WHAT]
2011년 크리스마스에 열린 대부분의 축구 시합에서 내국 병사는 누구를 상대했는가?	자국 병사	[WHO]
임진왜란의 정전회담의 결렬로 다시 일어난 전쟁은?	정유재란	[WHAT]
성종이 왕위에 오르기 전 장순왕후의 신분은?	세자빈	[WHO]
탐색을 시작할 때, 제일 먼저 설치해야 하는 것은 무엇인가?	술집	[WHAT]
G급 순양전함에 쓰이는 대포의 둘레 길이는?	16인치	[QUANTITY]
"지드래곤은 ""One Of A Kind""로 얼마만에 솔로로 무대에 복귀하는가?"	3년	[WHEN]
김순명은 무엇에 의해 사망했나요?	대포공격	[WHAT]
알렉세이 나발니가 혼수상태였을 당시, 비행기는 어디로 향하고 있었나요?	모스크바	[WHERE]
흉노를 공격하려는 계획에 상반된 의견을 가진 자는?	호군도위 조충국	[WHO]
마이크로소프트사 윈도우의 시장 점유율이 줄어들기 시작한 해는?	2016년	[WHEN]
이스트앵글리아 왕국의 초기역사에 대한 자료인 <교회사>의 저자는?	비드	[WHO]
땅꾼자리 제타의 최대 크기는 무엇보다 큰가?	목성궤도	[WHAT]
루터가 교육의 장으로 가장 강조한 곳은 어디인가?	가정	[WHERE]
초기 출혈성 천연두의 주된 사망 원인은 무엇인가?	심부종	[WHY]
도스토옙스키의 작품에 담긴 기독교 사상은 무엇에 기반한 것인가?	정교회 교리	[WHAT]
인정식이 입지를 넓히는데 걸림돌이 된 그의 사상은?	사회주의	[WHAT]
윤치호는 서재필을 찾아간 후 어느 지역으로 갔나?	상하이	[WHERE]
국부가 담겨있는 항아리 뚜껑에는 무엇이 적혀있나?	국부의 주인의 이름	[WHAT]
남대문 전투의 시발점이 된 사건은?	시위대 1연대 1대대장 박승환이 자살	[WHAT]
카라만리는 누구에게 맘루크 칼을 하사했나요?	오배넌	[WHO]
의존성을 사용하려는 객체는 무엇을 호출할 수 없나요?	외부 코드	[WHAT]
2005년에 맨체스터 유나이티드의 구단 경영권을 얻은 인물은?	맬컴 글레이저	[WHO]
대내림'을 행한 뒤 다음 순서는?	‘돌돌이’	[CITE]
에포케의 이유를 제시한 책은?	《피론 어록》	[CITE]
여성들이 입대할 수 있는 세력은?	사파티스타스	[WHAT]
가끔씩 북동부 지역에 살고있는 오리너구리들을 사냥하는 포식자는 누구인가?	악어	[WHO]
정녀 7명 중 한 명을 모시고 간 집안은?	회진임씨	[WHAT]
노르망디 침공이 시작된 년도는 언제인가요?	1944년	[WHEN]
아즈텍 문명을 침략한 나라는?	스페인	[WHERE]
인격이 달라질 때 그 전의 기억을 잊어버리는 질환은 무엇인가요?	해리성 기억상실	[WHAT]
미이라를 활용해 많은 의학적 지식을 얻은 것은 누구인가?	이집트인	[WHO]
고속국도법이 철폐되어 어떤 법에 속하게 되었나?	《도로법》	[CITE]
영화《제일하우스 록》을 연출한 사람은 누구인가요?	리처드 트로프	[WHO]
프랭크 베이커의 반환을 거부한 사람은 누구인가?	벤자민 버틀러 소장	[WHO]
임시발병규정에서 채택된 군사는 무엇에 능력이 뛰어난가?	궁마	[WHAT]
피해자들의 탈출을 막기위해 보닌이 운전석 문을 제외한 다른 문에서 모두 없애버린 것은?	내부 손잡이	[WHAT]
아카풀코에 새로운 열대 요란이 일어난 날짜는 언제인가요?	9월 1일	[WHEN]
역사상 가장 오랫동안 이용된 용광로는?	와카야마 제4고로	[WHAT]
미국과 영국, 소련의 외교적 대표들의 논의가 이루어진 자리는 무엇인가?	모스크바 3상회의	[WHAT]
윤치호가 조지아주에서 재입학한 학교는?	에모리 대학(Oxford College of Emory University)	[WHERE]
리위안훙이 총통 자리에 있을 때 베이징에서 쿠데타를 일으킨 사람은 누구인가?	안휘도독 장쉰(張勳)	[WHO]
송세호를 극동을 관리했던 사업가로 기사를 냈던 곳은 어디인가?	《동아일보》	[WHERE]
제천시가 시내버스에 LED 행선지표지판을 설치하기 시작한 해는?	2010년	[WHEN]
볼러의 능력을 판단할 수 있는 기준은?	볼러가 빼앗은 위켓의 숫자	[WHAT]
2007년 자유 지수 순위 참여 국가 중 꼴찌를 한 국가는?	에리트레아	[WHERE]
밀본을 얕잡아 본 인물은 누구의 친구였나요?	수천	[WHO]
태평양 전쟁 당시 필리핀에 진격하기로 한 사람은?	더글러스 맥아더 장군	[WHO]
3년간 레논이 부인과 떨어져 지낸 시기를 뜻하는 말은?	"""잃어버린 주말"""	[CITE]
크리스마스 정전을 더이상 볼 수 없게 된 해는 언제인가?	1916년	[WHEN]
1816년에 구제동맹을 만든 사람들은?	진보적인 성향의 청년 귀족	[WHO]
앙리의 부인은 누구의 후손인가?	로렌초 데 메디치	[WHO]
12월 8일 기습 공격을 행한 군대는?	핀란드군	[WHAT]
티타노케라톱스가 펜타케라톱스보다 더 유사한 종은?	트리케라톱스	[WHAT]
네메스는 보통 누가 사용하던 물건인가?	파라오	[WHO]
더듬이의 곤봉의 분절이 2개인 개미는?	혹개미	[WHAT]
포츠머스 조약에 따라 일본이 러시아로부터 받아낸 것은?	북위 50도 이남의 사할린 섬 및 조차지 요동 반도	[WHAT]
도차기현 남서부에서 군마현 남동부까지의 평야 도시들을 연결하는 노선은 현재 주로 어떤 역할을 하는가?	지역의 통근·통학 인구를 위한 여객 철도	[WHAT]
윤치오가 특파대사직에 고용된 것을 막으려한 나라는?	일본	[WHERE]
766부대의 본부는 북한의 어디에 있나요?	북한 회령시	[WHERE]
수십 년 동안 아카디아 주민들에게 충성 맹세를 받기 위해 매진했던 국가는?	영국	[WHERE]
하나님을 대신해서 새 언약을 세운 주체는?	예수님	[WHAT]
일본에서 환상게임 애니메이션 TV 시리즈를 약 1년간 방영했던 방송사의 이름은?	테레비 도쿄	[WHAT]
6월 28일에 북한은 어디를 점거하였는가?	서울	[WHERE]
티무르 다음으로 바그다드를 다스리게 된 사람은?	사르다하르(Sarbadar)의 크와자 마수드 사브자바리	[WHO]
이규완은 고종 황제를 폐위시킨 이후에 누구를 올리려고 했나요?	박영효	[WHO]
포켓몬의 종은 총 몇 개인가?	251 종류	[WHAT]
한왕은 항우에게서 누구를 빼앗아 자기 편으로 만들려고 했나요?	구강왕 영포	[WHO]
헨리가 리처드를 언덕 아래로 유인하기 위해 타격에 쓴 무기는?	대포와 화살	[WHAT]
스트라디바리우스 악기에 사용된 밀도 높은 단풍나무의 원산지는?	크로아티아	[WHERE]
육아 적응력이 떨어져 아이들을 방임한 인물은?	시모무라 사나에	[WHO]
래드왈드 왕이 죽고난 뒤 그가 다스리던 지역은 어떤 왕국이 통치하게 되었나?	머시아 왕국	[WHAT]
왕정이 끝난 뒤 네팔 공산당이 국회에서 차지한 자리의 개수는?	총 299석	[WHAT]
함경 방언에 영향을 받은 말들은 어디에서도 쓰이나요?	서남 방언	[WHERE]
식량이 부족한 시기를 어떻게 표현하는가?	보릿고개	[HOW]
일본의 전투기법을 연구하며 중국 군사고문으로서의 역할을 수행한 사람은?	첸노트	[WHO]
고려 태조가 즉위한 곳은 이전에 누가 자리를 잡았던 곳인가요?	궁예	[WHO]
맥헨리가 육군 장관 자리에 오른 해는?	1796년	[WHEN]
압델 파타 엘시시 이전 이집트 대통령은?	무함마드 무르시	[WHO]
로제르에게 안티오키아가 적으로부터 안전한 이유를 전한 사람은?	베르나르도 총대주교	[WHO]
킹을 구하기 위해 그의 아버지가 사용한 기술은?	패왕지고권	[WHAT]
루돌프는 누구 다음으로 죽었는가?	장남인 한스	[WHO]
방실이가 미군 부대에서 처음으로 활동하기 시작한 해는?	1982년	[WHEN]
미국이 베트남의 정부에 간섭할 수 있게 만든 사건은?	디엔비엔푸 전투	[WHAT]
밀월 관계로써 미국이 지속적으로 보급하고 있던 것은?	군사 원조	[WHAT]
17세기 식민지 정착민들이 메이플 시럽 대신 단 맛을 내는데 사용한 것은?	흑설탕	[WHAT]
고려에 대성아악을 전파한 사람은?	휘종	[WHO]
헥토르의 부인을 노예로 부렸던 인물은?	네오프톨레모스	[WHO]
종자식물의 분지는 무엇이 자란 것인가?	겨드랑이눈	[WHAT]
프로 베르첼리의 별명은?	하얀 사자 군단	[WHAT]
1854년 미국이 일본과 수교를 하면서 맺은 조약은?	미일수호통상조약	[WHAT]
티칼에게서 마야의 중심 도시라는 명성을 뺏은 도시는?	카라콜	[WHERE]
우찬의 데뷔골 덕분에 페네르바흐체가 얻은 것은 무엇인가?	유로파리그 준결승전 진출권	[WHAT]
일본의 직선기선 인정요구로 인한 EEZ의 경계는?	울릉도	[WHAT]
근대적 대기업은 무엇을 야기하였나?	경영자 자본주의	[WHAT]
아인이 옥림과 헤어진 이유는?	삼각관계	[WHY]
접시 돌리기를 보여준 등장인물은 무슨 동물인가요?	낙타	[WHAT]
코알라는 하루에 최대 얼마 정도의 수면을 취하는가?	20시간	[WHAT]
그리스의 군대를 막기 위해 열강들이 막아버린 지역은?	피레아스	[WHERE]
글리세르알데하이드 3-인산이 생성되는 반응은?	해당과정	[WHAT]
토미 도허티의 지도 아래 첼시 선수들은 무슨 색 양말을 신게 되었는가?	하얀	[WHAT]
신라시대에 만들어진 작품이라고 추측하는 근거는?	경상남도에서 출토되었다는 점	[WHAT]
예성강 입구에서 대전차포에 피격당한 부대는?	오스트레일리아 해군	[WHAT]
니시노미야 이서에서 급행 정기 운행은 언제까지 했나?	2009년 3월	[WHEN]
누구와의 만남이 매사추세츠 족에게는 불행이었는가?	필그림 청교도들	[WHO]
제호퍼가 바이에른주 총리직을 죄더한테 넘긴 해는?	2017년	[WHEN]
오버월드의 레벨 제한을 풀기 위해서 플레이어는 능숙도와 완수도에서 어떤 티어를 달성해야 하는가?	S	[WHAT]
미시시피 주에서 미시시피 강과 만나는 강은?	야주 강	[WHAT]
의결권 없는 주식을 뺀 발행주식총수에서, 주주가 주식 몇 개를 보유해야 초과 주식에 대해 의사를 표명하지 못하게 되는가?	100분의 3을 초과하는 수	[WHAT]
두위밍을 불러 들인 사람은?	장제스	[WHO]
2014년 박근혜 대통령이 '한반도 평화통일을 위한 구상'을 주제로 한 연설문은 무엇으로 명명되었는가?	드레스덴 선언	[WHAT]
SS 소속 군인 중 영국 제1 공수 여단 2대대와 교전한 인물은 누구인가?	파울 그레브너(Paul Gräbner) SS대위	[WHO]
송진우가 윤치호를 찾아온 날은?	1919년 1월 17일	[WHEN]
Presocratics'는 어느 나라 말에서 비롯된 단어인가?	독일어	[WHERE]
노르웨이 사절단이 스웨덴 왕녀를 요구한 것은 언제인가?	1018년	[WHEN]
파르네제가 엘프헬름으로 가기 위해 탄 배의 이름은?	해마호	[WHAT]
돈 봉투를 건네주라고 명령한 사람으로 의심 받은 사람은 누구인가?	김효재 전 청와대 정무수석	[WHO]
우르바노 5세가 일시적으로 설립을 허용한 대학교는?	크라쿠프 대학교	[WHAT]
인공호흡기에 쓰이는 에너지는 무엇을 통하여 압력을 만들어내나요?	컴프레서	[WHAT]
트롱트낵 요새는 어느 나라가 사용하는 요새인가?	프랑스	[WHERE]
금동신묘명삼존불은 어떤 양식으로 만들어졌는가?	중국 남북조시대의 불상 양식	[WHAT]
국가가 군인 징병시 주민을 찾아 군복무에 적합한지를 파악하는데 필요한 것은?	호적	[WHAT]
반 아이들에게 세리가 누구를 좋아한다고 들통났나요?	욱	[WHO]
2010년 기준으로 유럽 평의회 의원 회의 특별 참가국이 아닌 나라는 어디인가?	벨라루스	[WHERE]
영화 네파리우스: 머천트 오브 소울스의 유통사는?	엑소더스 크라이	[WHAT]
아뇨나가 두 번째 해외 진출을 한 해는?	1961년	[WHEN]
프라이드 하우스는 누구에 의해 처음 설치되었는가?	딘 넬슨	[WHO]
넬리 킴이 경기에서 은메달을 획득한 종목은 무엇인가?	개인 종합 운동	[WHAT]
윤치호가 서양인을 높게 평가하면서 사용한 단어는?	'우월한 인종'	[CITE]
IPTV가입자가 특정 방송 채널을 시청하기 위해 필요한 장비는 무엇인가?	셋톱박스	[WHAT]
빌리가 정글짐에서 떨어져서 부상당한 부위는?	머리	[WHAT]
1979년 일본시리즈 우승팀은?	히로시마 도요 카프	[WHAT]
존스 일행은 살인 장면을 보고 범인을 쫒을 때 무엇을 타고 이동하는가?	자동차	[WHERE]
내트 터너는 어디 출신인가?	사우스햄턴 카운티	[WHERE]
1989년 당시 티베트는 어느 나라에게 통제를 받고 있었나요?	중국	[WHERE]
오이 샌드위치를 처음 만들기 시작한 국가는?	영국	[WHERE]
아이스크림과 우유를 하나의 음료로 혼합하기 위해 사용하는 컵의 재질은?	스테인리스강	[WHAT]
일부 노선이 어번 네트워크 구역에 소속되지 않았던 해는?	1988	[WHEN]
윤치호는 어떤 인물의 통역을 맡았나요?	조선을 방문한 선교사들	[WHAT]
마우리츠가 자신의 정적을 제거한 것은 몇 년인가?	1618년	[WHEN]
제니가 아장에 의해 장애를 가지게 된 신체 부위는 어디인가?	눈	[WHERE]
원숭이들이 도구를 사용하여 견과류를 얻는 모습을 보고 알 수 있는 학습행동은 무엇과 가장 연계되나?	보상	[WHAT]
아서를 낳은사람의 남편은?	콘월	[WHO]
문제가 사망한 뒤 왕이 된 사람은 누구인가?	경제	[WHO]
스바프를라미는 누구의 손자인가?	오딘	[WHO]
일제강점기 당시 조선 지식인들이 일본 정부에게 일본인과 동등한 권리를 요구하는 계기가 된 사건은?	3.1 만세 운동	[WHY]
타티키오스는 1097년에 십자군들을 돕기 위해 어디로 갔나요?	니케아	[WHERE]
조쉬마자의 이적 이후 그의 역할을 대신한 인물은?	윌 그리그	[WHO]
대한민국에 농구가 처음 상륙한 해는?	1907년	[WHEN]
협동조합당의 근간 역할을 하는 단체는?	영국 협동조합 연맹의 의회위원회	[WHAT]
피츠로이는 항해 중 누구의 생각을 받아들이고 있었나?	라이엘	[WHO]
1949년 8월 6일에 북한군을 발견한 뒤 무찔렀던 연대는?	제7연대	[WHEN]
이언 캐머런의 아내가 매킨지 앤드 컴퍼니의 국제 경영 상담자로 일하기 시작한 년도는?	1990년	[WHEN]
오브스테트릭스의 뜻에 대해 연구한 사람은?	미국의 고대사 연구자 새러 포메로이	[WHO]
스페인이 영국에 빼앗겼다가 다시 차지한 지역은?	플로리다 주	[WHERE]
현대 사회에서 전쟁의 궁극적인 목적으로 보는 것은?	정치	[WHAT]
17세기 이전 베이크드 빈즈는 어떤 콩으로 만들었는가?	아메리카에서 자생하는 콩	[WHAT]
경상도가 만들어질 떄 중점이 되었던 곳은?	영남 지방	[WHERE]
비트겐슈타인이 소피야 야노프스카야를 만났던 연도는?	1939년	[WHEN]
공하류의 무서운 새우라는 의미는 어떤 동물 종류의 외형에서 따온 것인가?	갑각류	[WHAT]
송상현의 위패가 있는 절은?	송공사(宋公祠)	[WHAT]
"아물레흐티에서 ""최저의 인간쓰레기""라고 지칭한 사람들은?"	적핀란드 여성	[WHO]
디오게네스는 누구에 의해 죽임을 당했나요?	바리사이파	[WHO]
하이든의 <천지창조>에 영향을 준 것은?	헨델	[WHAT]
S/W 취약점 찾기 대회에서 수상한 해커그룹들이 찾은 보안 취약점의 특징은?	파급력이 높은	[WHAT]
기원전 234년에 진나라는 어디를 다시 침략하기로 하였나요?	조나라	[WHERE]
전북 남원과 전남 나주가 특별 재난 지역으로 지정된 것은 언제인가?	8월 13일	[WHEN]
줄리에 두보의 <<제공>>을 비행 전술학교의 교본으로 사용한 국가는?	미국	[WHERE]
아오테아로아는 보통 뭐라고 해석하는가?	"""길고 하얀 구름의 땅"""	[CITE]
여운형의 행동을 친일로 매도한 인물은 누구인가?	소설가 김동인	[WHO]
헬싱키, 비푸리, 발케아코스에서 첫 여성적위대가 만들어진 년도는?	1918년	[WHEN]
급성 기관지염 치료를 위해 약과 함께 추천되는 것은?	휴식	[WHAT]
에드워드 스톤은 백버드나무의 어떤 것을 사용하여 사람들을 해열할 수 있었나?	껍질 즙	[WHAT]
ISO 26000는 기업이 무엇을 시행할 때 필요한 지침서인가?	사회적 책임(CSR)	[WHAT]
<Notes on the State of Virginia>에서 오아이오강이 지구상에서 가장 아름다운 강이라고 표현한 사람은?	토머스 제퍼슨	[WHO]
1954년 총선에서 자유당과 라이벌이었던 인물은?	윤병구	[WHO]
프랑켄슈타인과 앙리 관계를 알 수 있는 노래는?	"""너의 꿈 속에서"""	[CITE]
1951년과 1952년의 레슬링 대회에서 안데르베리에게 패배한 인물은?	가리발도 니촐라	[WHO]
2005년에 하라 연구진들이 발견한 작용을 줄일 수 있는 물질은?	데프레닐	[WHAT]
천주교로 종교를 바꿨다는 의심을 받았던 학자는?	다산 정약용	[WHO]
백인들이 신대륙으로 갈 때 탔던 배는?	메이플라워호	[WHAT]
베토벤은 무엇에 대한 근심으로 유서를 작성하였나요?	청각 장애	[WHAT]
고든은 블랙메사 연구소의 어디에서 일했나요?	C구역	[WHERE]
왕식렴의 도움을 받아 왕의 자리를 차지하려고 한 인물은 누구인가요?	정종	[WHO]
올리벤사가 1297년 이후 처음으로 소유 국가가 바뀐 해는?	1801년	[WHEN]
꿀풀과와 유사하게 생긴 식물은?	현삼과	[WHAT]
천지가 용호라고 불리게 된 계기를 제공한 사람은?	4명의 사냥꾼	[WHO]
정태가 혜주의 약 봉투를 본 곳은?	혜주의 집	[WHERE]
북지황군위문단 파견에 지원을 해준 기구는?	조선총독부	[WHAT]
10월 23일 독일군은 어디에서 후퇴하던 중이었나?	핀란드	[WHERE]
10월 15일에 호르티를 붙잡은 사람의 소속은 어디인가?	독일군	[WHERE]
우룡은 그림에서 어떤 모습으로 묘사되었는가?	머리가 크고, 가늘고 허약해 보이는 동체를 꼬아놓은 모습	[WHAT]
추측으로만 채헌덕이 범인이라고 발표한 단체는?	대한민국 내무부 치안국	[WHAT]
1990년 FIFA 월드컵 당시 한국은 2차전에서 어느 국가에 패배했나요?	스페인	[WHERE]
슈파이어는 어느 주의 도시인가?	라인란트팔츠	[WHERE]
구룡이 위치한 도는?	충청도	[WHAT]
팩트의 후손들이 반대한 것은?	은의 채굴	[WHAT]
미카엘이 가진 권력을 잃고 죽은 해는?	1078년	[WHEN]
소영이 창문을 두드리는 모습을 바람에 흔들리는 것으로 착각한 인물은?	희민	[WHO]
지방 당국은 무엇을 목표로 특정 분야에만 투자하였는가?	재정 수입 확대	[WHAT]
아멧의 네 부분 중 하나로 머리부위와 연결되어 올렸다 내렸다 할 수 있는 부분은?	바이저	[WHAT]
홍승대가 임금 체불로 고소한 사람은?	충청북도지사 박중양	[WHO]
고흥 월포농악은 어떤 굿의 한 종류인가?	도서해안굿	[WHAT]
KBO 리그의 첫 번째 승부 조작 사건이 일어난 연도는?	2011년	[WHEN]
판타로스에게 메넬라오스를 화살로 쏴 죽이라고 사주한 것은 누구인가?	여신 아테나	[WHO]
흑기사의 막강한 오라력은 어디서 오는가?	증오	[WHERE]
2017년 총선거에서 50석을 차지한 당이 만들어진 달은?	9월	[WHEN]
1979년 이래로 가장 큰 폭발이 관측된 화산은?	트바쉬타 화산	[WHAT]
세계 1차 대전이 끝난 직후에 메테스키는 무엇으로 일했나요?	기계공	[WHAT]
리루이취앤의 스승이 심층적으로 연구한 학자는?	칸트	[WHO]
고등학교에서 문,이과로 나뉘어지지 않게 되는 해는 언제인가?	2018학년도	[WHEN]
헨슬로가 처음으로 지질학 강의를 들은 때는 언제였나요?	1819년	[WHEN]
연합군이 유일하게 피해를 입었던 지역은 어디인가?	가마이시	[WHERE]
스콴토가 고향으로 귀향한 년도는?	1619년	[WHEN]
주로 튀김류나 육류 종류와 곁들여 마시는 주류는?	맥주	[WHAT]
일부 중국인 네티즌들은 누구로부터 사과를 받길 원했는가?	태국의 배우인 와친윗 치와리	[WHO]
게오르기 테르테르의 처남은?	이반 아센 3세	[WHO]
예루살렘 성경이 많이 보급되기 전에 사용되던 것은 무엇인가요?	두에랭스 성경	[WHAT]
시각예술가들이 존 케이지의 혁신을 받아들임으로 시작된 현대 미술의 트렌드는?	탈경계	[WHAT]
핵무기 공유 협정을 맺은 경우 발사에 필요한 물건은?	듀얼키	[WHAT]
코끼리 모습의 폭포에 이름을 붙여준 부족은?	꼬호족	[WHAT]
장궁병들은 어떤 무기를 통해 기사들의 말을 공격했나요?	화살	[WHAT]
국제적십자운동을 처음 시행한 사람은?	앙리 뒤낭	[WHO]
토스카나에서 밀라노군를 여러 차례 이긴 싸움 상대는?	베네치아	[WHO]
웨일스가 잉글랜드에 복종하는 계기를 제공한 민족은?	노르만	[WHY]
기존보다 더 재미있는 타입의 놈이 만들어지면서 다시금 정원 요정의 인기가 오른 시기는?	1970년대	[WHEN]
카르타고 회의에서 기독교회의 선택을 받지 못한 이론을 주장했던 인물은?	펠라기우스	[WHO]
1930년대 당시 가장 유명했던 놈 만드는 사람은?	톰 메이저볼	[WHO]
현민의 저주가 악화된 것은 무엇이 밝혀진 이후인가?	사체의 신원	[WHAT]
기독교여자청년회가 한국에서 쓴 명칭은?	조선여자기독교청년회연합회	[WHAT]
1787년 해임된 인물의 원래 지위는?	재정총감	[WHO]
뚜르개나 새기개를 만들때 필요한 재료는 무엇인가?	흑요석	[WHAT]
독일 기사단은 누구의 지휘 아래 트란실바니아로 이동했나요?	헤르만 폰 잘차	[WHO]
일본에게 처음으로 공격을 퍼부었던 서양의 군함은?	와이오밍 호	[WHAT]
가브릴라 데르자빈이 장교 시절 진압한 사건의 주동자는 누구인가?	푸가초프	[WHO]
포라얘르비가 핀란드 합병을 결정한 해는?	1919년	[WHEN]
알베르트가 그의 가정부와 결혼한 것은 무엇을 주기 위해서인가?	연금	[WHAT]
야마토 박물관은 주로 어떤 기술에 대해 전시하고 있나요?	선박 제조 기술	[WHAT]
홀즈워스의 곡은 에디 반 헤일런이 무엇을 개시하게 하는데 영향을 주었는가?	라이트 핸드 주법	[WHAT]
술탄에게 거절한 대가로 8년동안 포위된 곳은?	콘스탄티노폴리스	[WHERE]
콘코바르는 에흐네 다음으로 누구와 혼인하였나?	무간 에탄카트레크	[WHO]
시위 행진은 남대문과 더불어 어느 방향으로 이어졌나?	대한문	[WHAT]
관천대가 소실된 시기는?	임진왜란	[WHEN]
마윈이 만리장성 안내를 하며 친분을 쌓은 인물은?	야후!의 창업자 제리 양	[WHO]
우측 2칸 전체에 설치되어있는 것은?	문	[WHAT]
석불입상의 대좌와 비슷한 양식을 보이는 불상은?	경주 남산탑의 석불	[WHAT]
대좌 중 홀로 다른 무늬가 그려진 것은?	중대	[WHAT]
일리리아어는 다키아어 그리고 트라키아어와 같이 무엇을 형성한다고 추정되는가?	트라키아일리리아어파	[WHAT]
이누족의 썰매의 재료로 사용되는 나무 종류는?	박달나무	[WHAT]
이오에 착륙하기 위해서 탐사선이 이용하는 것은?	역추진 로켓	[WHAT]
베이 스트리트의 중요성이 부각되었던 연도는?	1931년	[WHEN]
제2차 세계 대전 이전에 삼각대를 사용했던 기관총 종류는?	중(重)기관총	[WHAT]
히로시마 희생자에게 바치는 애가의 변경 전 곡명은?	8'37'	[WHAT]
마루게'의 끈기에 감탄하여 그가 학교 다니는 것을 허락했던 인물은?	‘제인’	[WHO]
비행기를 통해 입국하는 사람들이 반드시 써서 내야하는 것은 무엇인가요?	건강질의서	[WHAT]
카이사르는 브리튼의 추운 날씨로 인해 어디로 후퇴했는가?	갈리아	[WHERE]
발키리가 처음으로 도입된 해는?	2017년	[WHEN]
쿠데타 정보를 얻은 인물이 이후에 도망갔던 곳은?	카르멜 수녀원	[WHERE]
중화소비에트공화국의 시초가 된 장소는?	징강 산	[WHERE]
시음자들은 포도주를 맛보기 전에 무엇의 냄새를 맡나요?	유리 잔	[WHAT]
란돌포는 어느 섬에서 해적질을 결심하였는가?	키프로스 섬	[WHAT]
성제가 즉위하기 전의 왕은 누구인가?	원제	[WHO]
마리아 수도원을 옮겨가게 한 사람은?	퐁스 드 발메	[WHO]
1870년대 이후로 더욱 발전한 것으로 총을 사용한 군의 병과는?	포병	[WHAT]
둘째 아들이 죽기 전에 사망한 사람은 주룰루와 어떤 사이였나요?	남편	[WHAT]
1883년 대한 제국에 들어온 독일 해군 음악단이 소속된 함대는?	헤르타	[WHAT]
여성해방 이론에 마르트스주의을 접목시키자는 주장을 한 사람은?	밀리탄트(Militant)	[WHO]
태어난 지 얼마 안 된 웨이게오쿠스쿠스는 무엇이 달라지는가?	색채	[WHAT]
훗날 파우라바 왕국을 세운 민족은?	푸루족	[WHAT]
조지 4세의 즉위 연회가 열린곳이 지어진 해는?	1097	[WHEN]
존 프레스톤이 성직자로 활동한 교회는 어느 국가에 있었나요?	영국	[WHERE]
러시아어 교사 양미숙의 얼굴이 붉은 이유는?	안면홍조증	[WHY]
1972년에 실시된 서독 총선거에서 뽑아야 하는 서베를린의 의원 수는?	22	[QUANTITY]
일왕의 편지를 가지고 고종을 협박한 인물은?	이토 히로부미 조선통감	[WHO]
데이빗은 평행우주를 증명하기 위해서는 어떤 기계가 필요하다고 주장했나요?	300-qubit의 양자컴퓨터	[WHAT]
바다뱀자리 방향에 위치한 중력체가 움직인 원인은 무엇으로 추정되나요?	직각자자리 은하단	[WHY]
워렌이 영화 스텝진에게 급여 대신 주기로 한 것은?	영화 수익	[WHAT]
조경의 할아버지는 누구인가?	소을	[WHO]
일본에서 가장 긴 고속도로의 마지막 지점이 되는 도시는 어디인가?	아오모리 현 아오모리 시	[WHERE]
델리가 만든 발명품 중 산화 되지 않는다고 알려진 것은?	철 기둥	[WHAT]
동심원 우주 이론을 만든자로 코페르니쿠스의 우주 체계에 영향을 끼친 사람은?	아리스토텔레스	[WHO]
말제르브가 1776년에 퇴직한 곳은?	튀르고 내각	[WHERE]
산스크리트어 문법학 전통을 처음 연구한 인물은?	파니니	[WHO]
페리 정부가 막을 내린 시기는?	3월 30일	[WHEN]
에르네스트가 떠나면서 마짜에게 남긴 것은?	편지	[WHAT]
신익희는 어느 장소에서 윤치호에게 독립운동 참여를 권유했나요?	종로청년회관	[WHERE]
판매자가 소비자가 원하는 물건을 조달해와 판매했던 방식은?	카운터 위주의 상점	[WHAT]
2008년 2월 6일에 마이너 리그 계약을 맺은 선수가 100번째 경력 홈런을 친 날은?	7월 29일	[WHEN]
미국 관세사들이 짝퉁 판매 사이트를 제재한 시기는?	2009년	[WHEN]
사탄이 따뜻한 마음을 가진 주인공으로 등장하는 작품은 무엇인가?	"""사우스 파크"""	[CITE]
나치 강제 수용소 수감자 중 가장 높은 비율을 차지한 민족은?	유태인	[WHAT]
7월 4일 북한군이 전투를 벌인곳은?	음성 북방 동락리 부근	[WHAT]
거문도를 포트해필턴이라고 불렀던 국가는?	영국	[WHERE]
바르나 십자군의 구성국가는?	서구 기독교 국가들	[WHERE]
1970년대를 중심으로 남녀간의 통속적인 사랑을 표현한 대중적인 내용의 저서는?	《욕망의 거리》	[CITE]
중국공산당의 본사는 어디에 있나요?	옌안	[WHERE]
1859년에 중부 이탈리아를 병합한 나라의 왕은?	비토리오 에마누엘레 2세	[WHO]
쿠라이시 부족이 후발을 숭배하는 장소에 대해 글을 썼던 인물은?	디오도로스 시켈로스	[WHO]
노르드인 탐험가들과 함께 북아메리카 북대서양 해안에서 세 개의 땅을 찾아낸 인물은?	레이프 에이릭손	[WHO]
도미니시가 밴드에서 맡았던 역할은?	리드 싱어	[WHAT]
청동기 이전 모계 사회의 존재를 찾아낸 학자의 이름은?	마리야 김부타스	[WHO]
빨치산 파는 누구를 중심으로 파벌을 구성했나요?	김일성	[WHO]
버클러를 이용하거나 애초에 방패의 장점을 버리고 양손 무기를 썼던 사람들은?	보병 기사(말에서 내린 기사)	[WHO]
안티고네스가 셀레우코스를 기습 침략하며 시작된 전쟁은?	바빌로니아 전쟁	[WHAT]
1024년에 조지아로 도망간 인물은?	바그라트	[WHO]
일본의 헌법 제1조의 이념을 받쳐주는 내용은 무엇인가요?	"""국민주권"""	[CITE]
토머스 베켓이 캔터베리의 대주교관으로 들어가기 전 사망한 인물은?	런던의 주 장관인 길버트 베케트	[WHO]
커스터드 중 진한 크림의 제형은 주로 어디에 사용되는가?	에클레르	[WHERE]
자신의 애첩과 함께 몰래 일본으로 도망간 자유당 인물은?	장경근	[WHO]
독일 A집단군을 고립시키기 위해 소련군이 펼친 전술은?	'토성 작전'	[CITE]
1970년대 중반, 이즐링턴역에서의 노선 연장에 필요한 예산은 얼마였는가?	3860달러	[QUANTITY]
제우스를 크레타 섬에 숨겨 키운 신의 남편은?	크로노스	[WHO]
서 베를린의 독일 오페라를 현대적인 고대 양식으로 연출한 사람은?	젤너	[WHO]
교황 스테파노 9세가 사망한 년도는?	1059년	[WHEN]
가잔 칸이 해방 몽골 노예 부대의 사령관으로 임명한 사람의 본래 직위는 무엇인가?	재상	[WHAT]
주산을 비판한 사람은?	노벨 물리학상 수상자 리처드 파인만	[WHO]
만지로가 나카하마 성을 부여받은 해는?	1853년	[WHEN]
에리오르에게는 효력이 없는 마법은?	달 속성의 마법	[WHAT]
공격을 받아 쓰러진 우시를 보고 화가 나 공격한 인물은?	루피	[WHO]
스퀴드워드를 주로 무시하는 등장인물은?	스퀴리움	[WHAT]
제1차 세계 대전 기간 중에 목숨을 잃은 인도인은 모두 몇 명인가?	47,746명	[QUANTITY]
프로이센이 독일 종교가 서로 끈끈하게 뭉쳐질 수 있도록 칼뱅파와 루터파를 포함한 신교들을 합친 해는?	1817년	[WHEN]
존 벨루시는 코카인과 무엇을 함께 주사했는가?	헤로인	[WHAT]
와타루가 부활동을 시작한 이유는?	성적이 부족	[WHY]
여운형의 산소는 어디에 있는가?	서울시 강북구 우이동	[WHERE]
하이팅크가 계관 지휘자라는 수식이 붙기 시작한 년도는?	1999년	[WHEN]
명함은 어디에 보관해야 하나요?	명함 케이스	[WHERE]
외국인 선교사들은 어떤 사람들의 부탁을 거절했는가?	일본인들	[WHAT]
최초의 여성적위대가 참고한 부대 모델은 어느 국가의 것이었나?	러시아	[WHERE]
볼셰비키와 멘셰비키가 갈라선 해는?	1903년	[WHEN]
게펀은 툴라기에 누구를 초대하려 했나요?	존스	[WHO]
교황 요한 바오로 2세는 카마라 대주교와 함께 누가 인간다운 삶을 살 수 있도록 도왔는가?	민중들	[WHO]
옵티마테스를 마침내 쓰러트리고 힘을 얻은 사람은 누구인가?	율리우스 카이사르	[WHO]
누가 이슬람군에게 연설을 했나?	카슈샤브	[WHO]
오카와 슈메이와 대화를 나눴던 인물이 일본으로 갔던 해는?	1937년	[WHEN]
최영손이 아버지, 형제들과 파저강으로 정벌 간 년도는?	1433년(세종 15년)	[WHEN]
암흑에너지가 우주에 가하는 힘의 종류는?	척력(밀어내는 힘)	[WHAT]
학생은 성서의 어떤 부분을 모두 자르기 시작했는가?	가난한 사람들에 관한 성서 말씀	[WHAT]
황용주는 어떤 단체의 자산을 빼앗아 정수장학회를 설립하였나요?	부일장학회	[WHAT]
1944년 미국, 영국, 캐나다 연합군 공동작전을 수행한 프랑스의 지역은?	노르망디에 상륙작전	[WHERE]
유노를 사랑과 결혼의 척도를 나타내주는 신으로 비유하는 신앙은?	점성술	[WHAT]
군자정은 누구를 기리기 위해 지어졌나?	일두선생	[WHO]
클린턴의 군대 내 성소수자 권리 정책에 대한 보수진영의 생각은 무엇인가?	군생활에서 별 반응을 보이지 않는 정책	[WHAT]
수감 생활의 고통에 비하면 고문의 고통은 아무것도 아니라고 기술한 인물은?	다블뤼 주교	[WHO]
은미희가 《누에는 고치 속에서 무슨 꿈을 꾸는가》로 상을 받기 전에 연습 삼아 소설을 집필했던 기간은?	6년	[WHEN]
가내작업반을 별도로 만들어 상품을 판매하면 얼마의 조세가 징수되는가?	이윤의 3 - 10%	[WHAT]
가수 '최승이'가 무용 공연을 펼쳤던 작품은?	영화 《그대와 나》	[WHAT]
위협 첩보때문에 문 전 대표 신변은 누가 보호하였는가?	경찰	[WHO]
라인하르트 연대가 대적한 상대는?	소련군	[WHO]
<백설공주에게 죽음을>이 아마존에서 가장 많이 팔린 기간은?	32주	[WHEN]
마르티노가 교황이 되는 것을 승인했었지만 후에 후회한 사람은?	동로마 황제 콘스탄스 2세	[WHO]
재판에서 교황 하드리아노 1세와 교황 레오 3세가 수도원의 땅을 불법적으로 차지했다고 주장한 사람은?	파르파 수도원장 인고알드	[WHO]
웨사구셋에서 학살당한 것은 누구인가?	인디언	[WHO]
반구헌에 거주하던 인물은?	정기필(鄭夔弼)	[WHO]
엘로이즈의 삼촌 이름은?	풀베르투스	[WHO]
크렘린을 되찾아온 러시아 사람은?	드미트리 포자스키	[WHO]
포이즌 필 조항에 의거해 옵셔널벤쳐스코리아의 대표이사가 타의로 물러날 경우 받게 되는 금액은?	50억원	[QUANTITY]
페일로드군과 카크스군이 힘을 합쳐 맞서 싸운 적은 누구였는가?	슈테드니어스군	[WHO]
인도 철학은 나스티카와 무엇으로 분리되어 있었나요?	아스티카	[WHAT]
리비우가 우크라이나의 민족주의 사상의 핵심이 된 계기는?	제2차 세계 대전	[WHY]
선비족 족장 독발수기의 침입에 대응하여 가충이 출전할 것을 추천한 사람은?	임개	[WHO]
셀주크가 시르다리야 근처로 이주하기 전의 거주지는?	하자르 제국	[WHERE]
야마다 히사시의 팀 감독은 누구인가?	모리 마사아키	[WHO]
탑신의 몸돌 앞면에는 어떤 글씨가 쓰여져 있나요?	'해련지탑(海蓮之塔)'	[CITE]
타스만 빙하와 머치슨 빙하에서 흘러내린 물의 최종 도착지는?	태평양	[WHERE]
1976년 오프 시즌 훈련 당시 요미우리 OB코치는 누구였나?	오고 히로시	[WHO]
메카동을 우주의 끝에 날리려는 목표를 가진 인물은?	메카닉 박사	[WHO]
지구연방군이 붉은 혜성이라 부르는 인물은?	샤아	[WHO]
갈릴레오가 발견한 다른 위성과 달리 이오에게만 존재하지 않는 것은?	물	[WHAT]
다래 열매의 껍질은 무슨색인가요?	초록색	[WHAT]
혈액침하가 나타나는 혈액성분은?	적혈구	[WHAT]
아그리콜라가 아일랜드 인접하여 성을 축조한 장소는 어디인가?	브리타니아 해안	[WHERE]
비트켄슈타인이 케임브리지 대학교수로 임명되면서 얻은 것은?	영국 시민권	[WHAT]
어린갑의 비늘조각을 고대 로마에서는 무엇이라 불렀나?	스쿠아마에	[WHAT]
잉천이 유명해지는 것은 어떤 작품 발표 후인가?	≪배은망덕≫	[CITE]
245점 미만의 세포에게 잡아 먹힐 수 있는 홀은?	화이트홀	[WHAT]
니렌기 성과 밀접한 관련이 있는 성은?	요시다 성	[WHAT]
윤치호가 서재필을 찾아간 이후 향한 지역은?	상하이	[WHERE]
유세군은 누구와의 관계 때문에 시를 지었나요?	곤막	[WHO]
지동설의 옹호자들을 억누른 기관은?	교회	[WHAT]
정보 통신 분야와 관계를 가진 광운대학교의 시발점은?	조선무선강습소	[WHAT]
테세우스의 어머니는?	아이트라	[WHO]
위에서 아래로 하중이 작용할 경우, 보의 아랫부분은 어떻게 되나요?	인장	[WHAT]
이를 빈약한 용이라 여긴 국가는 어디인가?	일본	[WHERE]
가장 먼저 손기정 선수의 활약상을 칭찬한 언론사는?	조선중앙일보	[WHAT]
1986 피파 월드컵 8강전이 열린 곳은?	에스타디오 아스테카	[WHERE]
이 그림은 석가모니의 어떤 모습을 담았나?	설법장면	[WHAT]
칠갑산 암각화의 그림은 어떠한 방식으로 표현되었나?	세선각 기법	[HOW]
전체주의의 특징을 규정한 한나 아렌트의 저서는?	『전체주의의 기원』	[CITE]
연역법과 같이 수학에서 증명하는데 사용할 수 있는 방법은?	수학적 귀납법	[WHAT]
교육부가 주장하는 자사고 지정에 관한 마지막 주 결정자는?	교육부 장관	[WHO]
고속 증식로는 경제적 측면이 어떤 단계에서 기존 방식의 원자로를 뛰어넘고자 하는가?	실용로 단계	[WHAT]
독일의 화력전에서 살아남은 건물은?	교회	[WHAT]
윤치호가 미국의 특징이 인종주의라고 생각하게 만든 인물은?	기독교선교사들	[WHO]
로키가 슬레이프니르를 낳을때 변신한 동물은?	독액이 떨어져 로키는 고통에 몸부림치게 된다.	[WHAT]
일년 전쟁에서 가장 강력한 기체도 이기지 못한 인물은?	아무로 레이 소위	[WHO]
미국과 영국의 경계를 서쪽의 로키산맥까지 연장하게 된 회담은?	앵글로-미국 회담	[WHAT]
호박 잎의 끝 부분은 몇 개로 나뉘어지는가?	5개	[QUANTITY]
자유 연상은 어떤 학문을 근거로 한 기법인가요?	정신분석학	[WHAT]
경제위기에 맞서 임금 협약의 중지를 주장한 사람은?	엔다 케니	[WHO]
첼레스티노 1세가 기록상으로 처음 언급되었을때의 직책은?	부제	[WHO]
리치몬드 발렌타인이 제작한 칩은 무엇을 파괴하기 위해 만들어졌나요?	인간	[WHAT]
엔지니어 루카의 부인의 직업은?	성악가	[WHO]
연방과 평화 협의를 하려고 한 사람은?	지온 공국 공왕 데긴 소도 자비	[WHO]
뇌전증이 가장 많이 발병하는 때는 언제까지인가?	생후 1년	[WHEN]
빅토르가 집으로 향하기 전에 누구의 연주를 들었나요?	베니 골슨	[WHO]
쿠즈네초프는 누구의 명령을 거역하였나요?	스탈린	[WHO]
명륜당이 대성전 남쪽에 설립된 후 제주향교는 어떤 모습을 띠고있나?	‘좌묘우학’	[CITE]
평균적으로 「공주」로 지냈던 자들은 어떤 유형의 학생들이었나?	우수한 인재	[WHO]
유무를 가르쳤던 사람의 아버지는?	유교	[WHO]
레닌그라드 제품보다 결점이 적은 전차포를 생산하는 공장은 어디인가?	고리키 공장	[WHERE]
그리스인들은 보니파시오를 무엇이라 불렀나요?	보노수스	[WHAT]
베토벤을 낭만주의 파로 회유하려고 했던 인물은 누구인가?	E. T. A 호프만	[WHO]
분과에 한 개의 씨가 들어있지 않은 풀의 종류는?	현삼	[WHAT]
미국 댈러스의 코튼볼에서 있었던 경기에서 독일이 전반전에 넣은 골 수는?	3	[QUANTITY]
베토벤에 대한 루돌프의 존경심의 증거를 간직하고 있는 곳은?	빈 악우협회	[WHERE]
힐이 사관학교 병원에서 임질의 치료를 받은 때는 몇 월이었나요?	9월	[WHEN]
최초고용계약을 통해 무엇이 쉽게 가능해질 수 있는가?	해고	[WHAT]
여장승과 남장승 중에 키가 더 큰 것은 무엇인가?	여장승	[WHAT]
궁예에 대한 민간 전승 중 궁예의 말년에 관한 이야기가 전승되는 곳은?	명성산	[WHERE]
하인리히 4세는 어디에서 잡혀 감옥에 들어가게 되었나요?	마인츠	[WHERE]
여운형이 태어난 직후에 출생한 남자 형제의 이름은?	여운홍	[WHO]
일본이 반자본주의 사회가 되었다고 라고 주장한 조직은?	혁명적공산주의자동맹	[WHAT]
델핀이 친구에게 버림받고 방황한 도시는?	파리	[WHERE]
디오도로스 시켈로스의 직업은?	역사가	[WHO]
아프리카의 축구 국가대표팀들 중 처음으로 8강에 올라갔던 팀은?	카메룬 축구 국가대표팀	[WHAT]
아카디아 주민들에게 강제 퇴거 명령을 내린 인물은 누구인가?	찰스 로렌스	[WHO]
상하이의 황방을 차지하도록한 인물은 어디의 수장인가?	일국회	[WHO]
안토니우스 함대 중 탑이 달린 전투 갤리인 함대 수는?	230척	[QUANTITY]
보수파와 민권파는 어떤 이유로 폭행 소문을 퍼뜨렸나?	이토 내각을 공격	[WHY]
베니그노 아키노가 암살당한 장소는?	마닐라 공항	[WHERE]
현재 모란봉 언덕에서 부벽루를 담당하는 시설은?	요양원	[WHAT]
카쿠레인저와 오레인저가 맞서 싸우는 요괴를 만든 인물은 누구인가?	바라노이아	[WHO]
공공사업과 관련한 갈등이 유발되는 현장에서 사용되는 문구는 무엇인가?	“나리타처럼 되지 말자(成田のようにならないようにしよう )”	[CITE]
<존 윅>의 장르는?	네오 누아르 액션 스릴러	[WHAT]
원동기장치자전거와 일반 자전거의 세금을 다르게 매기기로 한 지역은?	충남도	[WHERE]
폰지 사기에서 새로운 투자자들을 끌어들여야 하는 것은 무엇을 얻기 위함인가?	기존 보다 훨씬 더 많은 투자금	[WHAT]
고노에 다다코의 결혼 전 이름은?	시게히메	[WHAT]
메드닌 전투는 누구의 마지막 전투인가?	에르빈 롬멜	[WHO]
이병주가 박정희와 함께 다녔던 학교는?	신경군관학교	[WHERE]
파키케투스는 주로 어디에서 생활했었나요?	물가의 건조한 육지	[WHERE]
총재 선거에서 라이벌이 없어 다른 파벌들의 표를 받아 당선된 인물은?	아소 다로	[WHO]
페르시아 제국을 건설한 인물은 누구인가요?	키루스 2세	[WHO]
유일한 생존자가 정신을 차렸을 때 그는 누가 유괴당했다는 것을 알게되는가?	아들	[WHO]
인주 이씨와 안산 김씨가 친척이 된 방법은?	혼인	[WHAT]
자유심증주의는 누구의 의견을 가장 중요시 생각하는가?	법관	[WHO]
조선총독이 시국강연을 위해 도 대표를 모은 해는?	1919년	[WHEN]
김활란을 대표로 기독교 여성과 사회주의가 결합하여 만들어진 것은?	근우회	[WHAT]
라텍스 시트의 제작 최소 두께는?	0.18 mm	[QUANTITY]
견과류와 더불어 나이가 들어도 알레르기가 해결되지 않는 식품은?	조개류	[WHAT]
로버트 캐롤과 함께 두 동물군을 명확히 분류하는데 힘쓴 사람은 누구인가?	미셸 로린	[WHO]
네그리가 무력적인 봉기를 편드는 발언을 한 강의 장소는?	파리 고등사범학교	[WHERE]
오비디우스가 사망하기 전까지 머물렀던 지역은?	토미스(콘스탄차)	[WHERE]
굿펠로우나무타기캥거루가 주로 생활하는 장소는 어디인가?	나무 위	[WHERE]
쿠나시르 섬의 생태계는 소련 정부의 무엇으로 지정되어 보호받고 있나요?	국립 쿠나시르 자연보호구	[WHAT]
로제 프리츠의 언니 이름은 무엇인가요?	마리아 프리츠	[WHAT]
사람의 머리카락이 하는 가장 큰 기능은?	미용	[WHAT]
90분이 종료된 이후 더 주어진 시간동안 몇 골을 성공시켰는가?	2골	[QUANTITY]
후경이 간문제를 제거하고 황제가 된 년도는?	551년	[WHEN]
혼인이 허용되는 지위는?	번장	[WHO]
2개의 패키지와 아이템샵은 언제 새로 생겼나요?	2008년 8월 1일	[WHEN]
이이가 사망하기 세 달 전에 선조에게 청한 것은 무엇이었나?	관직(이조판서직)의 사퇴	[WHAT]
미네르바가 유피테르의 몸에서 벗어날 수 있게 해준 이는?	불카누스	[WHO]
비트겐슈타인이 불만을 가진 사람은?	러셀	[WHO]
알렉산더가 강가에서 진을 치고 시행한 전술은?	양동작전	[WHAT]
장승이 들어오지 못하게 막고 있는 대상은?	잡귀	[WHO]
홍타이지의 어머니는?	측복진 예허나라 맹고철철	[WHO]
그린란드는 덴마크로부터 무엇을 얻은 후 그린란드 자체의 깃발을 만들기로 하였는가?	자치권	[WHAT]
국내 대학중 스키부를 처음 만든 대학이 개최한 스키대회가 열린 년도는?	2008년	[WHEN]
시시감비스가 알렉산더로 착각한 사람은?	헤파이스티온	[WHO]
자국 내 전쟁으로 이어진 반란을 농민들에게 부추킨 단체는?	가톨릭 교회	[WHAT]
아펜첼이너로덴주는 어떤 사건을 계기로 반주가 되었나?	1597년 스위스의 종교개혁	[WHY]
통상적으로 대장전이 간수하는 것은?	불교경전	[WHAT]
켈러 박사는 누구의 명령을 받고 실험하였는가?	월리스 브린	[WHO]
아들이 무엇을 옮겼기 때문에 아들의 어머니가 돌아가셨나?	선친의 산소	[WHY]
블레이드 러너에서 실제 사람같은 존재를 부르는 단어는?	리플리컨트	[WHAT]
윌리엄 헤이 칼드웰이 오리너구리에 대해 스코틀랜드에 보낸 메시지는?	"""난생 단공류, 부분할란(部分割卵)"""	[WHERE]
비디오 바이오스와 비슷한 역할을 하는 프로그램은?	시스템 바이오스	[WHAT]
표충사 삼층석탑에서 유물을 발굴한 해는?	1995	[WHEN]
살풀이춤은 원래 누가 추던 춤인가?	무당	[WHO]
어머니가 모든 재산을 가지고 사라졌다는 소식을 전해준 사람은?	김 변호사	[WHO]
사회화를 바라보는 관점은 거시적 관점과 무엇으로 나뉘나요?	미시적 관점	[WHAT]
요자파트가 처음으로 근무했던 은행이 위치한 지역은?	괴팅겐	[WHERE]
트랜잭셔널 메모리의 작업 수행 능력을 떨어뜨리는 부분의 명칭은 무엇인가?	오버헤드	[WHAT]
클레오파트라 3세가 후계자를 지명할 수 있도록 유언한 사람은?	퓌스콘	[WHO]
주미 야마다니시키의 산지인 곳은 예전에 어디에 위치하였었나요?	미노 군	[WHERE]
한국에 예수회 대학 설립을 건의한 연도는?	1948년	[WHEN]
제2차 보어 전쟁의 중반에 스뮈츠가 지휘를 받은 인물은?	쿠스 드 라 레이 장군	[WHO]
스파르타군과의 전투에서 트라쉬불로가 노예들에게 제안한 것은?	시민과 동등한 세금 부담의 특권(이소테레이아)	[WHAT]
카스카의 상태를 확인하려는 거츠가를 막은 사람은?	파르네제	[WHO]
몰락한 가문 중 진성공의 즉위에 영향을 미친 가문은?	조씨 일가	[WHAT]
양국 간 의무적 무역 협정을 체결한 회담은 몇년도에 시작되었는가?	1938년	[WHEN]
물리적 제거보다 우선시 할 경우 환경오염을 심화시키는 것은?	유화제	[WHAT]
1986년에 채택된 개인 및 가족기업법에서 인정하지 않은 것은?	고용 노동	[WHAT]
사회연구분야처럼 파피의 연구가 평판이 좋은 분야는?	정치사회학 분야	[WHAT]
엑스포대로가 시작되는 도로의 이름은?	돌산교차로	[WHAT]
진해를 뜯어 고치는데 걸림돌이 되었던 시설은?	진해향교	[WHAT]
아델리펭귄의 보온을 유지하기 위한 물질은 어디서 나오는가?	꼬리 근처의 분비샘	[WHERE]
소년이 동네 건달패에게 소개한 인물의 이름은?	미란(영정 분)	[WHO]
영 안은 어떤 나라가 지불해야 하는 전쟁 보상금에 관한 것인가?	독일	[WHAT]
전국시대 가신단에 요리키, 요리코들이 소속되면 무장의 힘이 세져 반란의 위험이 있다고 염려한 집단은?	다이묘들	[WHAT]
페리클레스가 발의한 법이 입제된 시기는?	기원전 451년	[WHEN]
<성경과 신학>의 저자는?	성경신학자 박윤선	[WHO]
잘라첸코와 세포 간부의 음모에 의해 리스벳은 어떤 처지가 되었는가?	살인용의자	[WHAT]
석조비로자나불좌상과 비슷한 시기에 제작되어진 것으로 보이는 불상은?	동화사 석조비로자나불	[WHAT]
제발트가 쓴 글들은 어떤 분위기를 가지고 있나?	멜랑콜리	[WHAT]
유굴리의 가족들의 목이 걸린 곳은?	화양(華陽)의 저잣거리	[WHERE]
톰 루빈에게 발견되었던 인물은 어디서 자랐나요?	남가주	[WHERE]
토치가 무엇을 가지고 있어서 돌로 바뀌지 않았는가?	김치스탈	[WHAT]
프랑크인 기수가 기병창을 사용하기 위해 접목시킨 것은 무엇을 탄생시켰나?	무장 기마병으로서의 중세 봉건계급	[WHAT]
역사상 최초의 공학자는?	임호텝이 파라오 조세르	[WHO]
후쿠다 총재가 주요 각료를 재임시킨 이유는?	국회 회기중이기도 하고, 국회 심의에의 대응을 위해	[WHY]
호라티우스와 가이우스 마에케나스를 만나게 해 준 사람은?	베르길리우스	[WHO]
전자기파가 비열적 유해성을 유발하려면 주파수가 몇 kHz 이하여야 하는가?	3kHz	[QUANTITY]
헨사토리르는 무엇으로 돈을 벌었나?	부유	[WHAT]
에티오피아 인구의 절반이 유지하고 있는 언어는?	게즈어	[WHAT]
나쁜 짓을 일삼고 도읍지를 장안으로 옮긴 사람은?	동탁	[WHO]
미하일 2세가 성화상 공경에 긍정적 입장을 취하게 만든 것은 누구인가?	테오도로	[WHO]
매춘을 정부와 사업 법규에 의해 규제해야한다는 관점은?	성 노동의 관점	[WHAT]
덜레스가 일본 정치인들보다 먼저 회담한 사람은?	더글러스 맥아더 원수	[WHO]
전격형 출혈성 천연두 환자는 무엇 때문에 눈의 흰자가 붉은색을 띠는가?	결막하 출혈	[WHY]
보은 방향의 도로를 폐쇄하라는 지시는 누구에게 내려졌나?	연대장 존 H. 마이켈리스 대령	[WHO]
응진전에서 상량묵서가 발견된 해는 언제인가요?	2010년	[WHEN]
조선후기 16나한상 중에서 호랑이와 함께 있는 나한상의 종류는?	복호나한	[WHAT]
흥천사 목조여래좌상과 전체적으로 흡사한 구조를 띤 불상은?	공주 동학사 목조석가여래삼불좌상	[WHAT]
선로 사용 시 융통성이 떨어지는 이유는 가까운 선로로 갈 때 무엇을 해야 하기 때문인가?	평면교차	[WHY]
디아도코이 전쟁은 누구의 죽음으로 인해 일어났나요?	알렉산드로스 대왕	[WHO]
닭들이 죽으면 어디로 처리하는가?	뒷산 웅덩이	[WHERE]
불가살이는 최시랑에게 무엇으로 감사한 마음을 전했나?	구슬 세 개	[WHAT]
분석에서 브라보케라톱스의 자매종으로 예상된 개체는?	코아후일라케라톱스	[WHAT]
양식 새우를 가장 많이 수출하는 국가는?	인도네시아	[WHERE]
아이오와 주민들의 인구 분포를 조사한 기관은?	인구 조사국	[WHAT]
카일이 약관에 서명하도록 한 인물은?	잡스	[WHO]
남아공과 더불어 리비아와 외교적인 마찰을 겪고 있는 나라는?	오스트리아	[WHERE]
스페인 내전에서 콘도르 군단이 게르니카를 박살낸 시기는?	1937년	[WHEN]
뱀 세마리가 꼬여있는 형태의 기둥이 처음 세워진 곳은 어디인가?	델포이	[WHERE]
조상들과 똑같은 모양으로 제작된 작품은 보통 어디에 전시되어있나요?	오르산 미켈레 박물관	[WHERE]
힌두교에서 한 철학적 분파의 스승을 뜻하는 단어는 무엇인가요?	구루	[WHAT]
마이크로소프트 윈도우보다 더 많은 사용자를 보유한 운영 체제는?	안드로이드	[WHAT]
조조에게 모개와 모개를 고소했던 사람 둘 다 세심하게 따져 보아야 한다고 조언했던 인물은 누구인가?	화흡	[WHO]
야마구치 다몬은 어느 전쟁에서 전사하였나?	미드웨이 해전	[WHAT]
황금 견장에서 찾아볼 수 있는 이집트의 신은?	하늘의 신	[WHAT]
사용자 열명 당 한명이 동의하면 무엇의 진행을 멈추나?	의견교환	[WHAT]
프리드리히가 겨울왕으로 불리게 된 전쟁은?	백산 전투	[WHAT]
이중근이 서울지방검찰청 검사로 재직할 당시에 맡았던 사건은?	열차 공안원들과 공모한 조직적인 열차 소매치기 사건	[WHAT]
관촉사 앞뜰의 4각 석등보다 큰 것은 무엇인가요?	구례 화엄사 각황전 앞 석등(국보 제12호)	[WHAT]
워드는 무엇에 열정적이었나?	연기	[WHAT]
영국은 그들의 군대 진영을 설립한 장소를 무엇이라고 불렀나?	포트해필턴	[WHAT]
1914년 말 크리스마스 편지를 독일에게 보낸 나라는?	영국	[WHERE]
이명법'에 쓰이는 언어는 무엇인가?	라틴어	[WHAT]
허리케인 아이작의 발생에 영향을 끼친 파동이 중앙아메리카를 통과한 날짜는?	8월 26일	[WHEN]
실리콘을 실리콘유로 만들기 위해 거치는 과정은?	실리콘	[WHAT]
대학에서 먹고 사는 방법을 가르치는 것은 합당한 일이라고 얘기한 인물은?	김훈	[WHO]
튀코 브라헤와 달리 코페르니쿠스의 주장만 믿은 사람은?	갈릴레오	[WHO]
키즈는 누구의 자백을 들었는가?	월터 네프	[WHO]
궁예와 석총이 공통으로 지향했던 불교 종파는?	법상종	[WHAT]
4월 14일 솔로들의 날을 상징하는 컬러는?	블랙	[WHAT]
오타와강은 무엇이 없어지면서 니피싱호 강을 따라 흐르게 되었나?	샹플랭해	[WHAT]
최종훈과 이종현이 무고함을 주장한 회사는?	FNC	[WHAT]
1502년 우르비노를 군사적인 지배하에 둔 사람은?	체사레 보르자	[WHO]
탄소에서 이성질체가 발생할 때 서로 다른 원자가 몇 개 결합하는가?	4개	[QUANTITY]
청나라 병사들의 이동이 허가된 지역은?	시베리아	[WHERE]
1921년에 한글을 널리 알린 잡지를 만든 곳은?	기독교창문사	[WHERE]
산업이 발달함에 따라 대기중 배출량이 많아지고 있는 것은?	기체	[WHAT]
소음으로서 도시조 군을 패닉에 빠뜨린 부대는?	신정부군	[WHAT]
점프맨 마리오의 외모 참고 모델이었던 인물의 직업은?	부동산 업자	[WHO]
리지웨이 사령관이 실시한 작전은 무엇을 점령하려고 했나요?	통제선	[WHAT]
노아에 의해 방주에서 내보내진 비둘기는 다시 돌아올 때 무엇을 가져왔는가?	올리브 잎	[WHAT]
고바야시가 협상을 두고 함대파와 대립했던 연도는?	1927년	[WHEN]
성원경에 대해 인물평을 적은 책은 언제 만들어졌나요?	1935년	[WHEN]
윤치호와 함께 개화당의 거사에 대해 비판했던 사람은?	윤웅렬	[WHO]
요비아누스가 황제가 되기 전에 지원한 원정의 지도자는?	율리아누스	[WHO]
이철희의 아내를 도와주고 있던 인물은?	이규광	[WHO]
톡 쏘는 것처럼 혀가 아린 매운맛을 내는 향신료는 무엇인가?	마라(麻辣)	[WHAT]
브르트니에르 신부가 체포된 날짜는 언제인가요?	2월 27일	[WHEN]
일월회가 창설된 곳은?	도쿄	[WHERE]
윤치호가 탐독한 저서를 쓴 인물의 국적은?	인도	[WHAT]
핀란드군을 이끌어 기습 공격을 하고 숲 속으로 철수한 인물은?	파아보 탈벨라	[WHO]
안드레이 마르코프 교수가 마르코프 행렬과 함께 개발한 연구는?	마르코프 연쇄	[WHAT]
개찰 외에서도 열차가 보이는 것은 역 승강장과 개찰 외의 사이벽이 무엇으로 되어있기 때문인가?	유리	[WHAT]
수지와 섞어 점조도를 조절하는 물감은 무엇을 그릴 때 쓰이는가?	유화	[WHAT]
브리지 픽업은 무엇을 활용해 넥 픽업보다 개선된 출력을 만들어내나?	많은 코일	[WHAT]
남쪽의 이민족과 밀접하고 백성들이 무지했던 곳은?	계양군	[WHERE]
동북한일연군은 김동한을 뭐라 표현했는가?	"""민족의 망나니"""	[CITE]
그리스국 이전의 국명은?	그리스 왕국	[WHAT]
기존 가내작업반에 속해있던 사람들은 어디로 소속을 옮겼는가?	공장	[WHERE]
양명황 음악가의 사인은?	교통사고	[WHAT]
육아에 있어 아빠가 아이의 선배 역할을 해야한다고 주장한 의사는?	하지현	[WHO]
금방 만들어진 라바시가 쉽게 재료로 쓰이는 음식은?	샌드위치	[WHAT]
조선에서도 윤치호를 유색 인종이라는 이유로 차별한 사람은?	미국인 선교사	[WHO]
사고기의 이륙장소가 3C로 바뀐 이유는?	기상 악화	[WHY]
인필드 플라이가 무효가 될 경우 해당 플레이는 무엇으로 판정되는가?	파울	[WHAT]
피아노 삼중주 7번의 별칭은?	대공 삼중주	[WHAT]
소총통은 무엇이 개량된 것인가?	승자총통	[WHAT]
외계인이 주인공을 괴롭히는데 사용한 것은?	B급 영화	[WHAT]
참호전 양상을 띄게 된 지역은?	엔강 계곡	[WHERE]
자신의 몸에서 발화가 가능한 사람들을 무엇이라고 부르나요?	'화염인간'	[CITE]
가짜 드미트리가 정부를 건립한 곳은?	투시노	[WHERE]
최재우가 프리스타일 스키모굴 부문 결승전에서 실격당한 대회는?	러시아 소치에서 열린 2014년 동계 올림픽	[WHAT]
민다와 테노리오는 누가 우승하도록 도왔나?	데포르티보 키토	[WHO]
《국민이 묻는다, 2019 국민과의 대화》에 참여한 정치인은?	문재인 대통령	[WHO]
두 번째, 세 번째 피아노 협주곡 중 먼저 세상에 알려진 곡은?	세 번째 피아노 협주곡	[WHAT]
윤활제 역할을 위해 잉크에 들어가는 물질은 무엇인가요?	지방산	[WHAT]
영국은 어느나라와의 싸움에서 승리해 코이누르 보석을 습득했나요?	시크 제국	[WHAT]
생태여성주의의 학문적, 철학적 하위분야는 무엇에 요점을 두고 있는가?	비인간 동물에 대한 인간의 착취	[WHAT]
우주와 천체의 현상을 관찰하며 일반적이지 않은 현상이 감지되면 왕에게 보고하던 관직은?	일관	[WHO]
쇄자갑이나 판금갑을 파훼하기 위해 개발된 무기는?	에스톡	[WHAT]
미국에서 기독교 근본주의가 정치적 성격을 띠게 되는 때는?	선거철	[WHEN]
알로이스 히틀러가 1900년대 감옥살이를 했을 때의 죄목은?	절도죄	[WHAT]
김옥균이 히라노초를 갔을 당시 믿고 의지했던 인물은?	나미	[WHO]
컴퓨터의 보안상태를 색상으로 나타내는 윈도우의 구성 요소는?	제어판	[WHAT]
방봉손이 44세였던 해는?	1839년	[WHEN]
아라카와강 방수로는 언제 완공되었는가?	1930년	[WHEN]
최수종이 <대조영>을 촬영하고 연말 시상식에서 대상을 수상한 년도는?	2007년	[WHEN]
유약을 바르지 않고 구운 도자기 표면의 이름은 무엇인가요?	조흔판	[WHAT]
불기둥 같은 날을 가진 검은 어느 나라의 것인가?	프랑스	[WHERE]
법적 의무를 행사하기 위해 무작위로 투표하는 것을 무엇이라고 하는가?	당나귀 투표	[WHAT]
생중계된 토론회를 진행자는?	박영환	[WHO]
조선민주주의공화국이 2019년 개발에 성공하여 조선중앙통신과 내나라에 보도한 기술은?	SoC	[WHAT]
코흐가 베를린 국립 위생원으로 간 다음 해에 발견한 균은?	결핵균	[WHAT]
나무로 만든 탱화는 뭐라고 부르는가?	목각탱	[WHAT]
저홍춘의 최초 거주민은?	왕(汪)씨 가족	[WHO]
청자 퇴화문두꺼비모양 벼루의 원래 목적지는?	개경	[WHERE]
출연진들이 나비어를 보다 쉽게 이해할 수 있도록 도움을 준 자는?	프로머	[WHO]
민주당이 고발하려고 한 사건이 일어난 해는?	2014년	[WHEN]
비트켄슈타인은 무엇에 따라 유대인으로서 대우를 받았나요?	나치의 인종법	[WHAT]
사리사를 처음 발명한 나라는 어디인가요?	마케도니아 왕국	[WHERE]
케니 아커만을 탄압하고 박해한 사람은 누구인가?	카를 프리츠	[WHO]
최용신은 어디에서 유학생활을 하다가 생을 마감했나요?	일본	[WHERE]
스파르타가 엘리스에게 도시의 독립을 강권한 시기에 일어난 무력적인 분쟁은?	펠로폰네소스 전쟁	[WHAT]
멜라네시안 관습을 따르는 재판소의 재판장을 선임하는 사람은 누구인가?	스페인의 왕	[WHO]
세바스찬 단친이 말한 공연이 열린 장소는?	쿡 카운티 교도소	[WHERE]
하사의 검은색 튜닉에 새겨진 문양은 무엇인가?	적십자	[WHAT]
극예술연구회의 창단 공연작품의 원작자는?	니콜라이 고골리	[WHO]
무엇을 감소시키기 위해 조현병 치료제를 꾸준히 먹어야하나요?	재발 위험	[WHAT]
바둑이와 패의 순서가 많이 다른 게임은?	포커	[WHAT]
청야전술로 약 100명 정도의 보어인 난민을 만든 인물은?	키치너	[WHO]
업스트림 전송 속도는 무엇을 전송하는 속도를 뜻하나?	자료	[WHAT]
미치류에게 견두류라는 새로운 명칭을 부여한 사람의 이름은?	에드워드 드링커 코프	[WHO]
검은 나나의 꿈이 신인문학상을 받은 해는?	1999년	[WHEN]
승려화원들은 누구의 소원을 이루고자 영수암 괘불을 그렸는가?	화주 심인 법사	[WHO]
우주에서 가장 많은 원소는?	수소	[WHAT]
줄리와 스튜어트가 기차에서 내린 것은 무엇 때문인가?	폭설	[WHAT]
기자회견을 잘 하지 않으면서 종종 유시만 말하던 인물은?	이승만	[WHO]
로블링이 왕복선에 의해 다친 부위는?	발	[WHAT]
차경복 기술위원장이 물러난 이후 기술위원장으로 선임된 인물은?	박경화	[WHO]
마르시온이 노드 형제단을 배신한 후 결성한 단체는?	블랙 핸드	[WHAT]
1000여 개의 후각 수용체로 구성되어있는 인간과 동물의 신체조직은?	후각 상피세포	[WHAT]
박흥대가 부산판례연구회 회장을 맡고 있으면서 근무하던 곳은?	부산고등법원	[WHERE]
브르타뉴와 노르망디를 구분짓는 것은?	쿠에농강	[WHAT]
지동설에 대해 확실한 근거를 발견한 브라헤의 제자는?	요하네스 케플러	[WHO]
영국이 오버로드 작전을 수행할 시점에 캉은 어느 나라의 지배를 받고 있었나?	독일	[WHERE]
모스크바 방송 차이코프스키 교향악단으로 개명될 당시 음악 감독은 누구인가?	블라디미르 페도세예프	[WHO]
경상남도 기념물 제289호를 창건한 인물은?	자장율사	[WHO]
출력 전압이 4배 가량 상승하는 것을 확인할 수 있는 자료는?	도면의 정현파	[WHAT]
플린트를 기본 공간으로 하여 다양한 영화를 제작한 인물은?	마이클 무어	[WHO]
빌리네 집 밑에 사는 사람은?	마거릿	[WHO]
풍발과 모용운이 끌어내린 황제는?	모용희	[WHO]
다운시프트족이 자신이 원하는 삶을 살기 위해 포기하는 공통 특징은 무엇인가?	고소득	[WHAT]
김 위원장이 중국을 처음 방문할 때 도착했던 곳은?	베이징(北京)	[WHERE]
비잔티움 제국이 베네치아 공화국과 조약을 맺은 것은 누구를 견제하기 위해서인가?	남부 이탈리아의 노르만 족	[WHO]
치프라스의 출생 국가는?	그리스 아테네	[WHERE]
어떤 법령에 통화가 불량일 경우에 전화 요금을 돌려받을 수 없다고 정해져있는가?	통신원령 제7조	[WHAT]
벨라루스 정부가 계속 권력을 가지고 있을 수 없었던 원인은?	내부 투쟁	[WHY]
오페라에서 클링조르의 마법에 걸려 꽃뱀으로 변한 인물 중 원래는 순수했던 인물은?	쿤드리	[WHO]
타미코는 누구의 자식인가?	회장 마스조	[WHO]
라파엘의 10월14일 오전 12시경의 풍속은?	45노트	[QUANTITY]
아편보다 위험성이 더 높은 마약은?	헤로인	[WHAT]
가정이 있는 아테네 여성에게는 무엇이 우선순위였나?	가정에 전념하는 것	[WHAT]
요나라는 고려를 침입할 때 무엇을 핑계로 삼았는가?	강조의 정변	[WHAT]
보닌의 지인 중 마술사의 나이는?	21세	[QUANTITY]
작품 《트로일러스와 크리세이드》가 일으키는 논란을 해결하기 어렵다고 본 사람은?	프레드릭 S. 보아스 (Frederick S. Boas)	[WHO]
원래의 전차가 T-84로 바뀌도록 만든 전쟁은 언제 일어났나요?	1990년	[WHEN]
쓰루오카 송신소까지 영상을 전송하는데 걸림돌이 된 지형은?	2000m 정도 되는 산	[WHAT]
벨바스트와 스카하가 있는 지역은?	벨바스트 월드	[WHERE]
교황 우르바노 2세가 그레고리오 7세를 원조했을 당시 그의 직책은?	추기경	[WHO]
5번째 확진자의 근무지는?	국무원	[WHERE]
사랑의 여름 당시 히피의 주류 계층은?	젊은이들	[WHAT]
아이스너 회장과 회사 이사들을 상대로 주주들이 낸 소송은 몇 년 후에 판결났나?	8년	[WHEN]
이월은 어떤 전투를 계기로 명예를 잃기 시작했는가?	게티스버그 전투	[WHY]
좌종당이 둥간족을 진압하기 위해 출동한 해는?	1868	[WHEN]
운주사석탑군이 만들어진 시대는?	고려시대	[WHEN]
야마토 뮤지엄은 어느 시에서 설립하였나요?	구레시	[WHAT]
주기적으로 고혈압, 두통, 다한등의 증상을 일으키는 병의이름은?	갈색세포종	[WHAT]
다리우스를 쫓아가기 직전인 알렉산드로스에게 급박한 소식을 전한 인물은?	파르메니온	[WHO]
일본이 국제해양법재판소에서 독도 문제를 제기할 수 없도록 규제한 법은?	유엔해양법 287조	[WHAT]
콘토미레의 주재료는?	타로토란	[WHAT]
비교적 쉽게 제대로 된 파네토네를 먹을 수 있는 나라는?	이탈리아	[WHERE]
19세기 이전의 소설은 내용의 흐름을 어떻게 서술하였나?	시간순	[HOW]
멕시코전 이후 장현수 선수의 바뀐 포지션은?	수비형 미드필더	[WHAT]
왕이 사내를 포박하는데 사용한 것은?	탯줄(이툼부)	[WHAT]
권력이 강한 가문 출신 사람들이 빠르게 승진하는 문제를 해결하기 위해 신돈이 실시한 정책은?	순자격식(循資格式)	[WHAT]
소비에트 연방이 수정주의를 도입한 해는?	1956년	[WHEN]
민주당 내부의 갈등을 해결하기 위해 양보한 측은?	신민계	[WHAT]
인종의 대처가 늦었다면 왕이 될 뻔한 인물은?	경원대군	[WHO]
난카이 전철의 안내도는 언제 사라졌나?	2016년 3월 1일	[WHEN]
일제강점기 이전 너비아니는 어디의 전유물이었는가?	궁중	[WHERE]
제국 초기 후원자가 필요없던 직업의 분야는?	무역	[WHAT]
막야검을 거절한 인물은?	계손	[WHO]
비오 11세가 돌아누울 수 없을 정도로 완전히 건강을 잃어버렸음에도, 그와 함께 일반 알현을 계획한 사람은?	도메니코 타르디니	[WHO]
호한야선우가 전한에 투항한 해는?	기원전 54년	[WHEN]
척수 반사 중 수면 중에 발생하는 것은?	바빈스키 반사	[WHAT]
조금씩 유럽사회가 계급사회로 접어들게 된 때는 언제인가?	중세 시대	[WHEN]
알제리가 독일과 악연으로 얽히기 시작한 해는?	1982년	[WHEN]
1059년 라테라노에서 열린 시노드에 참석한 주교는 몇 명이었나?	113명	[QUANTITY]
갈릴레이 위성의 이름을 지을 때 기준이 된 행성은?	목성	[WHAT]
현대 볼펜의 사용기간은 보통 어느정도인가?	2년	[WHAT]
〈Dearborn Independent〉에서 바루크는 누구로부터 비난 받았나요?	헨리 포드	[WHO]
자제단 본부의 단장은 누구인가?	박중양	[WHO]
입단 관련 정보는 기밀이지만 연락처나 존재 사실은 감추지 않는 단체는?	프리메이슨	[WHAT]
2009년에 15명의 교사들이 받은 징계의 원인은 무엇이었나?	시국선언	[WHY]
중장갑 하베스터는 누구를 태울 수 있나요?	보병	[WHO]
비율효과는 재화의 수요가 어떤 특징을 가지기 때문에 발생하는 효과인가?	유한성(有限性)	[WHAT]
잭슨이 정책을 실행하기 이전에 투표할 수 있던 사람은?	지주	[WHO]
야마오카 모모스케가 등장하는 시리즈와 백귀야행 시리즈의 공통 소재는?	요괴	[WHAT]
인도가 기술 원조를 받을 수 있게 된 연도는?	2006년	[WHEN]
좌종당의 명령을 듣고 북로로 간 인물은?	유금당	[WHO]
최초의 조선왕조 녹권은 누구에 의해 소장되고 있나요?	이원계의 가문	[WHO]
새로운 대형 중폭격기 개발을 위해 필요한 것은?	4발기 제작 경험	[WHAT]
조 디마지오가 보유한 홈런 기록이 깨졌던 날은?	7월 8일	[WHEN]
친구들이 네루다가 체포되는 것을 막기위해 네루다를 숨긴 곳은?	칠레의 항구 발파라이소의 한 집 지하	[WHERE]
루카치가 부다페스트 대학에 복귀한 이듬해 참석한 국제회의가 열린 도시는?	제네바	[WHERE]
초크가 통과시키는 전류는?	직류 전류	[WHAT]
군사 전초 기지의 용도로 쓰인 도시는 언제 만들어졌나요?	629년	[WHEN]
밀라노 대교구를 로마 교구에 예속시킨 밀라노 대교구장은?	위도 대주교	[WHO]
왕페이와 이혼한 사람은?	더우웨이(두유)	[WHO]
이턴이 처음 농구를 하도록 도와준 사람은?	톰 루빈	[WHO]
보증금은 누가 납입하는가?	채무자	[WHO]
백제 시대에 사면불 조성을 추진한 왕은?	성왕	[WHO]
지속성이 부족한 외견상의 급진성을 지칭하는 용어는?	'프티 부르주아적 급진주의'	[CITE]
씬님의 소속사는 어디인가?	DIA TV	[WHERE]
보통 정체성이라하면 누구의 것을 말하나?	인간	[WHO]
가이저 지진과 포항 지진의 공통적인 원인은?	물 주입	[WHY]
구스노키 마사시케 동상은 어디서 만들어졌나?	스미토모	[WHERE]
김준한을 쌍방울 레이더스 4대 감독으로 추천한 구단주의 이름은?	이의철	[WHO]
원사들의 제안을 찬성한 인물은?	웡원하오	[WHO]
아데마르가 남프랑스 제후군을 하나로 합치는 것과 연관이 있는 얘기를 주고받았던 인물은?	툴루즈의 레몽 4세	[WHO]
예언자 엘리야가 이스라엘에서 활동하던 시기는?	기원전 8세기 전후	[WHEN]
에드워드가 영향력을 넓히기 위해 설립한 것은?	부르크	[WHAT]
성우들이 스스로를 어필하기 위해 사용하는 것은?	목소리	[WHAT]
제1우크라이나 전선군이 베를린 공방전의 결과로 어디를 점령하였는가?	독일군의 수도	[WHERE]
워든역 터미널이 대중 교통의 중심이 되기 전 어떤 역이 중심 역할을 하였나?	러트렐 루프	[WHAT]
1960년대 중반 이후로 유지되던 인구 통계 학적 배당에 변화를 준 것은?	중국의 한 자녀 정책	[WHAT]
용수당을 만들때, 서양에서 맥아당을 대체하여 쓰는 재료는 무엇인가?	옥수수 시럽	[WHAT]
가운데 부분에서 종 제작 이유가 쓰여진 위치는?	가로 줄 아랫부분	[WHERE]
에글린턴 애비뉴에서 토론토 피어슨 국제공항까지 연결된 경전철의 건설계획이 발표된 해는?	2007년	[WHEN]
벤자민 바커의 부인을 노리고 있는 인물은 누구인가?	터빈 판사	[WHO]
황제로부터 전쟁의 마무리 임무를 받은 사람은?	나르세스	[WHO]
바르톨로메아가 재판관과 비교한 대상은?	해적	[WHO]
리듬 부분만 편집해서 수록한 1집 마지막 곡은?	Yoo Doo Right	[WHAT]
기존 전차에 무엇을 장착시키면 원형의 전차의 화력과 대등한가?	대구경의 대전차포	[WHAT]
가마쿠라코코마에 역의 이전 명칭은?	히사카 역(日坂駅)	[WHAT]
산마르코 대성당에서 귀중하게 생각하는 것은?	성당의 동쪽 날개	[WHAT]
볼룬드의 다리를 자른 사람은?	니두드 왕	[WHO]
문용선의 대학 시절 전공은?	법학과	[WHAT]
후기 판본에서 콘코바르 막 네사의 누이가 실종된 곳은?	에번 바허	[WHERE]
피해를 방지하기 위해 기업이 필수로 여기는 것은?	사고방지	[WHAT]
성화에서 인도자의 모습을 띤 인물의 품에 안긴 사람은 누구인가?	아기 예수	[WHO]
서양에서 유행하는 음악이 이란에 들어오기 전, 이란의 주 음악은?	전통 음악	[WHAT]
창흥측량학교를 신문에 홍보한 사람은?	학생 류승렬	[WHO]
박정희와 김종필에게 고소를 당했을 때 김준연은 이들을 어떤 명분로 반소했는가?	외환죄 혐의	[WHAT]
일한 만시즈는 레인보우 킥을 활용하여 누구의 수비를 뚫었나?	호베르투 카를루스	[WHO]
프리드리히 대왕의 군대와 연합하기 위해 라이프치히를 일임받은 사람은?	아들 디트리히	[WHO]
델라즈는 건담개발계획에 대한 정보를 얻고 난 후 무엇을 선택하였는가?	건곤일척의 총력전으로 대전과를 거두는 것	[WHAT]
리맥에 관련된 정보를 알린 언론은?	월스트리트 저널	[WHAT]
도마뱀자리 BL 천체의 중앙 부분에는 무엇이 있는가?	초대질량블랙홀	[WHAT]
최민수에게 내려진 판결은?	무혐의	[WHAT]
브리유니 회담에 참석한 세르비니아 측 인물은?	보리사브 요비치	[WHO]
조류의 난자는 어디에서 수정되는가?	체내	[WHERE]
아리스톤이 윤리적 판단에 필요한 일반적 경로 학습의 필요성을 부정했다고 평가한 인물은?	키케로	[WHO]
혈통친왕보다 높은 칭호가 만들어진 시기는?	발루아가 치세 말기	[WHEN]
빙 거리화 정리는 증명 도중에 어떤 공간을 사용하여 증명하는가?	무어 공간	[WHAT]
고고학자들은 어떤 상황일 때 원어를 활용해 원문을 복원하려고 하는가?	고문서로 발견된 유물이 원어로는 존재하지 않고 번역된 언어로만 존재할 경우	[WHAT]
석진형이 이사로 있던 음식업체의 이름은?	천향원	[WHAT]
남지기로회도는 무엇을 베낀 작품인가?	〈이기룡필남지기로회도〉	[CITE]
외골격으로 이루어진 곤충의 기관은?	날개	[WHAT]
엔베르 호자가 비판했지만 호자주의와 아주 세밀한 차이만 있는 사상은?	마오쩌둥 사상	[WHAT]
카탈리나의 부관 중 카탈리나의 약혼자와 동기인 인물은 누구인가?	안드레아 기지	[WHO]
파진 밀사이디는 결혼 전 어떤 직업을 가지고 있었나?	시그투나 공무원	[WHAT]
3월 14일 입법원에 의해 2차 독회를 통과한 법안은 무엇인가요?	동성가족관계법안	[WHAT]
조엽수림대와 온도가 비슷한 지역은?	지중해 연안	[WHERE]
임시찬성건의소의 설립과 재무 관련 정보에 관한 보도를 한 언론은?	《대한매일신보》	[CITE]
뉴욕 주지사의 지위를 놓고 듀이와 겨루었던 사람은?	민주당 현직 주지사 허버트 리먼	[WHO]
도천사지 내에서 발견되는 와편은 어느 나라 때 만들어진 것인가?	조선	[WHERE]
천궁도 점성술이 처음 생겼다고 하는 국가는?	헬레니즘 이집트	[WHERE]
하니가 한중가요제에 참여한 연도는?	2004년	[WHEN]
이번에 상영하는 영화에서 유일하게 모자를 쓰고 등장하는 인물은?	루이	[WHO]
퍼거슨 시의 무력 시위에 대응하기 위해 경찰이 사용한 물건은?	최루탄	[WHAT]
컴퓨터 지식으로 범법행위를 하는 사람은?	크래커(cracker)	[WHO]
민족문학작가회의 소속 소설가들이 시위에 참가한 장소는?	서울 시청 앞	[WHERE]
김영달의 가족이 만주로 이사간 해는?	1937년	[WHEN]
무굴 제국의 전성기를 이끌었으나 동시에 라지프트 제후의 지지를 잃은 사람은?	아우랑제브 황제	[WHO]
블록체인에 의해 새로이 만들어지고 있는 체계 중 가장 큰 범위를 차지하는 것은?	"""지급 및 송금"""	[CITE]
로마로 진군하려한 인물은?	가리발디	[WHO]
아내의 결혼 소식을 듣고 분노에 빠진 인물은?	데메트리우스	[WHO]
B형 항성보다 비이형 별의 스펙트럼에서 더욱 뚜렷하게 나타나는 현상은?	적외선 복사 현상	[WHAT]
가짜 드미트리가 1년이 넘게 공격해도 함락시킬 수 없었던 곳은?	모스크바 북동부의 성 삼위일체-성 세르기우스 수도원	[WHERE]
반토가 평상시에 맡고 있는 직책은?	오반의 지휘관	[WHO]
사리사에 취약했던 병종은?	기병	[WHAT]
처칠이 독일 해군의 암호책을 해독하기 위해 보낸 곳의 이름은?	40호실	[QUANTITY]
량쓰청 부부의 의견을 거절하고 중국 당국이 만든 것은?	도로	[WHAT]
금식을 철저히 지키면 궁극적으로 가는곳은?	천국	[WHAT]
요아힘 프리드리히의 친할아버지 이름은?	요아힘 2세	[WHO]
산업혁명이 처음 시작된 나라는?	영국	[WHERE]
통행증을 사는 것으로 무역 금지령을 피하고자 한 이들은 어느 나라 상인들인가?	중국	[WHO]
사도세자가 거짓말까지 해가며 즐긴 것은?	전쟁놀이	[WHAT]
동일한 동물령 몇 가지를 모으면 모드를 플레이할 수 있는 시간이 늘어나는가?	5	[QUANTITY]
사전처분에도 불구하고 양육 부모가 비양육 부모에게 아이를 보여주지 않을 때 위반 행위자에게 1천만원 이하의 과태료를 부과할 수 있는 제도는?	이행명령	[WHAT]
줏키의 이름을 작명한 사람은 누구인가?	조부인 하나다 키요테루	[WHO]
경기용 탄환 표면 코팅을 구리 대신 윤활재로 하는 이유는?	납중독의 위험을 방지	[WHY]
시작형 거대 모빌아머를 파괴한 것은?	화이트 베이스 대의 육박 공격	[WHAT]
경성제국대학에 1년동안 내는 비용이 이공학부 개설 이후 얼마로 변경되었나?	100만원 선	[WHAT]
순서수와 다르게 정렬 전순서 집합 외에도 존재가 가능한 것은?	기수	[WHAT]
고샤마인 봉기로 인해 일본은 어느 지역을 획득했는가?	마쓰마에 번	[WHERE]
새만금호에서 서식하는 어류의 종이 줄어든 가장 큰 이유는 무엇인가?	내만성 어류인 전어의 양이 크게 증가한 이유	[WHY]
트리노반테스족에 영향을 주기 위해 이행된 일은?	왕 만두브라키우스의 복위	[WHAT]
크리스티안 로젠크로이츠가 열여섯 살 때까지 머물렀던 장소는?	수도원	[WHERE]
서울중앙지검이 정윤회 씨의 국정 개입을 허위사실로 결론 지은 날짜는 언제였나요?	1월 5일	[WHEN]
폭탄을 국내로 몰래 가져온 단체는?	의열단	[WHAT]
스티븐 클라크슨의 전 아내의 현 남편은 누구인가?	존 랠스톤 소울	[WHO]
방초정 근처에 위치하며 마을의 구정물을 정화하는 곳은?	최씨담	[WHERE]
민수기 마지막 부분에서 여호와의 인도로 계획한 것들을 성공으로 이끄는 인물은?	모세	[WHO]
전통 건축 기술을 소멸 위기로 만든 기술은?	서양 건축 기술	[WHAT]
이범철이 의병활동을 저지하기 위해 파견된 곳은?	경상남도 지역	[WHERE]
아르보레아 주디카토국의 마지막 왕은?	굴리엘모 3세 디 나르보나	[WHO]
덴마크에서 독립한 후 노르웨이에서 만들어진 새로운 표준어는?	뉘노르스크	[WHAT]
아리타 슈조가 컴백상을 수상하는 맹활약을 보인 해는?	1988년	[WHEN]
1902년에서 1904년 사이에 어떤 이유로 서울에 전화를 50여 대밖에 설치하지 못하였나?	가설료가 비쌌기 때문	[WHY]
자본주의는 내부로부터 붕괴할 것이라고 본 사람은?	슘페터	[WHO]
제2차 인도차이나 전쟁이 끝났던 해는?	1975년	[WHEN]
모아이는 무엇으로 이루어져있나?	화산암	[WHAT]
식품이 오염되게 하는 것은?	매개체	[WHAT]
여공이 다시 자리에 올랐다는 사실을 늦게 알게 된 나라는?	초나라	[WHERE]
성벽 대규모 사업을 벌인 인물은?	2세 황제	[WHO]
세포이 항쟁은 언제 일어났나?	1857년	[WHEN]
미국 최고 미술학교가 위치하는 곳의 구체적인 명칭은?	칼리지 힐	[WHAT]
페레스베트와 부딪힌 전함의 이름은?	세바스토폴	[WHAT]
테아 레오니의 작중 이름은?	제니 러너	[WHAT]
태국인 요리사의 도움으로 도피생활을 시작했던 그룹은?	앤더스의 그룹	[WHAT]
가이아가 복수를 하기 위해 만든 것은?	낫	[WHAT]
화학 반응 발생 시 스스로는 무변하지만 반응 속도에는 변화를 일으키는 것은?	촉매	[WHAT]
하등 척추동물과 비교했을 때 신장의 재생능력이 한정적인 동물 종은?	포유류	[WHAT]
기형이 자동 소멸되어 진화에는 영향을 끼치지 않는다고 주장한 학파는?	생물측정학파	[WHAT]
데니를 조선 정부에 소개해준 인물은 누구인가요?	이홍장	[WHO]
선언형 프로그램의 알고리즘에 대한 정의와 반대인 개념은?	명령형 프로그램	[WHAT]
조이가 반한 사람은 누구의 동생인가?	요안니스 오르파노트로포스	[WHO]
진함이 진탕에게 뇌물을 상납한 뒤 얻게 된 직위는?	소부	[WHO]
9호선에서만 운행되는 열차 호수는?	6000번	[QUANTITY]
캐서린 엘리자베스 로빈스의 남편은 누구인가?	해리 프랜시스 홀더먼	[WHO]
한국판 뉴타입의 간행이 폐지된 해는?	2015년	[WHEN]
세포 셧다운을 실행해야하는 단백질은 어디에 있는가?	핵	[WHERE]
인도 정당의 상징은 누구를 위함인가?	문맹	[WHO]
장마전선'의 이동에 영향을 미치는 요인은?	아열대 능선	[WHY]
남한에 정착하기 위해 탈북자가 교육을 받아야 하는 기간은?	12주	[WHEN]
모진 고문으로 손상된 유진길의 신체 부위는?	살가죽	[WHAT]
미국기업이 원하는 작업자는 어떤 언어를 사용하나요?	영어	[WHAT]
서로의 배움에 개입하는 학습활동은 학습자의 지식과 함께 무엇을 발달시키는가?	기술	[WHAT]
헨슬로가 케임브리지 대학의 교수로 활동하기 시작한 해는 언제인가요?	1822년	[WHEN]
지하철이 댄포스 역에 정차할 것을 요청한 사람은?	토론토 시장 존 토리	[WHO]
신종 덥스텝이 오버그라운드로 되는데 크게 기여한 인물은?	스크릴렉스	[WHO]
클라우제비츠가 군인이 된 것은 누구의 영향인가?	아버지	[WHO]
조경왕 장의 아들은 누구인가?	선평무후 장오	[WHO]
인간의 불안전한 행위에 의해 일어나는 상황은 무엇의 원인이 되나요?	산업재해	[WHY]
초대 올림픽 월계수 수상자와 비둘기 모양의 연을 날리는 아이들이 같이 달리는 장면이 나온 올림픽은?	2016년 리우 올림픽	[WHAT]
일본은 어떤 명분으로 미국 군대가 자국에 머물기를 원하는가?	방어용 잠정 조치	[WHAT]
사람들이 태풍에 제대로 대비하지 못한 이유는?	태풍이 상륙한 때가 한밤중이어서	[WHY]
아테나이의 민주 정치를 파괴한 인물은?	필리포스 2세	[WHO]
드레드노트 악희사건에 동참한 버지니아의 남자 형제는?	아드리안 스티번	[WHO]
오티라 터널이 완공된 해는?	1923년	[WHEN]
최고 지휘부 구성원으로 선출된 사람들은 어디 출신인가?	장교 아카데미	[WHERE]
소위 천의 여왕으로 불리는 인물이 대륙에 발표한 방책은 무엇인가?	'마법금지정책'	[CITE]
서울교육대학교를 상징하는 동물은 무엇인가?	사슴	[WHAT]
아기스 3세가 여러 국가와 함께 대항한 국가의 이름은 무엇인가?	마케도니아	[WHERE]
미쿠를 다른 세계로 이끈 정체는?	신기한 검은 고양이	[WHAT]
농부들이 콩과 옥수수를 돌려짓기하는 이유는 무엇인가?	흙에서 영양물의 밸런스를 유지하기 위해	[WHY]
정해성이 불량배들에게 옆구리를 찔려 심한 부상을 입었던 장소는?	창경궁	[WHERE]
1880년대에 영국과 프랑스가 공동으로 다스리기로 한 지역은 어디였나요?	뉴헤브리디스	[WHERE]
앤더스 그룹은 시위하는 집단을 피해 누구의 집으로 갔는가?	앤더스	[WHO]
경희궁이 만들어진 시기는?	광해군 9년(1617년)	[WHEN]
서울시가 뚝섬지구에 돔구장을 지을 계획을 발표한 달은?	12월	[WHEN]
그리샤 예거가 3권의 자서전을 집필한 기간은?	13년	[WHEN]
테오티우아칸의 양식 무덤에 묻힌 사람은?	키니크 약스 쿠크 모	[WHO]
키징거 대연정 다음 총선에서 승리한 당은?	사민당	[WHAT]
윤치호의 사망원인은?	뇌일혈	[WHY]
1975년에 몬트리올에서 개항한 공항은 도심까지 얼마나 걸리나요?	50분	[WHAT]
한국교원대를 졸업해도 중등학교 교사임용시험의 응시 대상이 안되는 과는?	총 3일	[WHAT]
윤영채가옥의 건축 연도가 기록된 기와가 발견된 해는?	1978년	[WHEN]
발리오니는 무엇에 찔려 죽었나?	파이크	[WHAT]
콤바인에 대항할 수 있는 정보를 보내는 인물은?	주디스 모스맨(Judith Mossman)	[WHO]
보그가 만든 이메일 서비스는 무엇을 대상으로 만들어졌나?	가상 공동체	[WHAT]
설치 예술가와 건축 디자인 팀이 협력하여 가설한 작품의 이름은?	"""라이트스펠"" (LightSpell)"	[CITE]
폭클별의 에너지를 이용해 아루마스를 없애버리려고 하는 집단은?	우주해적단	[WHAT]
수메르인 관련 사료가 발견된 곳은?	이란	[WHERE]
요한 베르크만스가 사망한 날짜는?	8월 13일	[WHEN]
대한도서관 설립에 관한 기사를 다룬 언론사는?	황성신문	[WHAT]
빙글이 독보적인 위치를 차지할 수 있는 원인은?	관심사	[WHY]
조지아 서쪽에 가장 처음 살기 시작한 사람들은 어디로 부터 이주해왔나요?	아리안-카르틀리	[WHERE]
산체스가 피츠버그의 가장 아름다운 25인에 선정된 해는?	2007년	[WHEN]
사바나 원칙이 말하는 인간이 치장을 하는 이유는?	생물학적 본성	[WHY]
중앙에 위치하는 아미타여래좌상은 어떤 방식으로 연화좌 위에 앉아있나?	결가부좌	[HOW]
문정왕후가 보우를 도대선사로 올릴 당시의 조선 왕은 몇 세에 즉위하였는가?	정난정	[WHAT]
상대적으로 애니메이션의 캐릭터에 맞추는 것이 수월한 사람은?	전문 성우들	[WHO]
뮌헨 협약을 통해 전쟁을 모면하려고 했던 영국 총리는?	네빌 체임벌린	[WHO]
한수산 필화 사건 사망자의 직업은 무엇이었는가?	시인	[WHAT]
성인아이의 개념을 단계적으로 수용했던 국가는?	미국	[WHERE]
사회성을 기를 수 있는 학습 활동 유형은?	집단학습	[WHAT]
북조선의 5대 혁명가극 중 비극적 결말을 맺는 가극은 무엇인가?	조선인민군협주단의 혁명가극 《당의 참된 딸》(1971)	[WHAT]
여성으로 과학분야에서 첫 대학 교수직을 맡은 사람은 어느 나라 사람인가?	이탈리아	[WHO]
엔 배어 콜의 맏이는?	도로시 에셀	[WHO]
시간의 흐름에 따라 재판 참가자들의 판결에 영향을 끼치는 것은?	감정 상태	[WHAT]
진아의 친할머니 이름은?	경선	[WHO]
김일성이 회고록을 직접 쓰지 않았다고 증언한 사람은?	황장엽	[WHO]
단순한 안티 바이러스 도구들이 네트워크 트래픽 점검을 통해 찾을 수 있는 것은?	흔한 루트킷들	[WHAT]
무엇이 이슈타르가 사랑한 대상을 죽음에 이르게 했나?	멧돼지	[WHAT]
피에르 루이지 반대 세력이 지지했던 사람은?	로마 제국의 카를 5세	[WHO]
벨콜로레 남편의 직업은 무엇인가?	농부	[WHAT]
기욤 뮈소가 집필하는 소설의 장르는?	로맨스	[WHAT]
레지널드 폴의 어머니는 언제 사망하였나요?	튜더 왕조 시대	[WHEN]
20세기 초반에 미치류를 나누기 위해 기준이 되었던 골격은 무엇인가?	척추뼈	[WHAT]
부녀자가 얼굴을 가리기위해 썻던 것 중, 고려시대에 사용한 것은?	몽수	[WHAT]
웃거나 화를 낼 때, 순간적으로 깊은 잠에 빠지면서 근육의 힘이 풀리는 현상은?	탈력발작(Cataplexy)	[WHAT]
동해와 남해의 경계가 부산 해운대구를 지나도록 정한 기관은?	국립해양조사원	[WHAT]
13세의 비르지타와 혼인하여 총 여덟 명의 자녀를 낳은 인물은?	울프 구드마손	[WHO]
노르웨이와 스웨덴의 언어를 섞어 쓰는 지역은?	베름란드	[WHERE]
부르주아 지식인을 중국 혁명에 참여시켜야 한다고 주장한 인물은 누구인가?	마오쩌둥	[WHO]
스페인 군과 트웨쉬 인디언 사이의 갈등의 계기가 된 물건은?	담요	[WHY]
새로운 공룡 화석이 더이상 생성되지 않기 시작한 시기는 언제부터인가?	제3기	[WHEN]
만경대학생소년궁전이 설립될 때 같이 건설된 것은?	광복거리	[WHAT]
오구즈 칸은 누구의 손자인가?	모굴 칸	[WHO]
1994 아시안 게임 축구 8강전에서 한국의 상대는?	일본	[WHO]
고니오가 오스만 제국의 지배에서 벗어난 해는?	1878년	[WHEN]
키라와 카가리 유라 아스하는 어떤 관계인가?	쌍둥이	[WHAT]
검찰 과거사위원회에서 당시 수사 기록을 꺼내 진상조사한 사건 이름은?	‘박종철씨 고문치사 사건’	[CITE]
2000년에 이오를 관측한 탐사선 중 이오가 황과 이산화황으로 덮여있음을 알린 탐사선은 무엇인가?	갈릴레오 호	[WHAT]
김석조, 고성모 등에게 자신과 함께 할 것을 권한 사람은?	고승천	[WHO]
젤라시오 1세가 교황의 권한을 부각하기 위해 주장한 권리는?	교황 지상권	[WHAT]
나인 브릿지 전략에서 러시아의 협력을 이끌어낼 수 있을 것으로 예상되는 분야는 무엇인가?	가스	[WHAT]
메디치 가문의 몰락 후 토스카나를 넘겨받은 사람은?	프란츠 (프란체스코)	[WHO]
구유고슬라비아의 6개 공화국이 최종적으로 모두 분리된 것은 몇 년인가?	2006년	[WHEN]
페르시아 원정군이 에레트리아를 무찌를 때 가장 먼저 전쟁을 시작한 지역은?	낙소스	[WHERE]
온타리오 주의 부총독이 된 인물은 어디 출신인가요?	해밀턴	[WHERE]
법적 구속력이 없는 법정은 누가 만들었나요?	버트런드 러셀	[WHO]
작클리와 밀담한 적이 있고 병단 내로 식인 괴몰로 변하는 와인을 퍼트린 인물은?	옐레나	[WHO]
테오도라와 재혼하기 전에 미하일 시슈만의 부인은 누구였는가?	데찬스키의 누이인 안나 네다	[WHO]
대륙 회의에서 코시치우슈코가 부여받은 직위는?	대륙육군의 공학 대령	[WHO]
1961년에 민족일보의 인쇄를 중지시켰던 부처는 어디인가?	국무원 사무처	[WHERE]
공연스태프들이 원하는 좌석에 원하는 색깔의 빛을 출력하기 위해 쓰는 도구는?	스마트폰	[WHAT]
고려후기 전주치소의 위치를 추정한 책은?	「남행월일기」	[CITE]
왕건을 임금으로 예우하는 의식이 치뤄진 곳은?	노적가리 위	[WHERE]
상기 백자입호는 어느 곳에서 주로 쓰였나?	조선왕실	[WHAT]
언론, 교육 등에 힘썼던 가톨릭 조직은 언제 활동하였는가?	일제시대	[WHEN]
톰이 등대지기로 가게 된 섬의 이름은?	'아누스 록'	[CITE]
현대에 점성술을 하는 사람들이 부정적으로 생각하는 단어는?	"""예언"""	[CITE]
곤충이 주변 환경과 비슷한 모양을 하는 이유는?	적에게 발견될 가능성을 줄여준다.	[WHY]
미국과 이라크 관리들은 하킴을 누가 죽였다고 보나?	아부 무사부 알자르카위	[WHO]
사하라 사막에 철도가 놓인 시기는?	1592년	[WHEN]
낙랑군이 설치된 장소에 있었던 국가를 망하게 한 장본인은 누구인가?	전한 무제	[WHO]
이정희가 1839년 교우 다섯 명과 함께 죽임을 당한 사실이 기록된 문헌은?	《승정원일기》	[CITE]
이준용은 어떤 처지라서 일본이 그를 우호적으로 받아들였나?	정치 망명객	[WHAT]
북한군이 국군을 기만하기 위해 배치를 바꾼 것은?	전차 2대	[WHAT]
국회의장 선거에 무소속으로 출마한 사람은?	이만섭	[WHO]
고려시대 매병은 당시에 무엇을 담는 용도로 쓰였나요?	참기름	[WHAT]
해양 생태계에서 가장 많이 볼 수 있는 착생식물은 무엇인가?	조류	[WHAT]
불경하다는 비난을 받은 인물은 누구인가?	기번	[WHO]
맥도날드의 합작회사 중 해운대 해수욕장과 광안리 해수욕장 부근 매장을 담당하는 곳은 어디인가?	맥킴	[WHERE]
코코뱅의 상품 가치를 정하는 데 영향을 주는 것은?	와인	[WHAT]
예허 국주의 자녀가 누르가치에게 보내졌을 때의 자녀의 나이는?	14살	[QUANTITY]
서울 올림픽 야구 종목에서 2위를 한 나라는?	일본	[WHERE]
네팔 의회 의원 중에서 투표를 포기하고 데모를 시작했던 인원은?	66명	[QUANTITY]
1977년의 이스라엘 총선거에서 리쿠드당은 어떤 정당과의 경쟁에서 승리하였나?	노동당	[WHAT]
포카혼타스와 결혼한 인물은?	존 롤프	[WHO]
프러데리와 마나워단이 수렵 중에 만난 동물은 무엇인가요?	흰색 멧돼지	[WHAT]
아게실라오스의 아버지는 누구인가?	아르키다모스 3세	[WHO]
이만규가 최초로 선고받은 형벌은?	사형	[WHAT]
싸움에 대비한 체육을 다룬 교육의 명칭은?	아고게(agoge)	[WHAT]
영토 확장의 공로를 세운 왕이 즉위한 해는?	570년	[WHEN]
나치와 이념전을 펼쳤던 소련의 이념은?	공산주의	[WHAT]
후지가오카 역을 기점으로 히가시야마 선과 연결된 노선은?	리니어 모터카 아이치 고속 교통 동부구릉선(리니모)	[WHAT]
<폴아웃 4>의 음악에 대해 긍정적으로 평가한 플랫폼은?	게임 인포머	[WHAT]
제3차 카얀데르 내각이 무너지게 된 계기는?	겨울전쟁	[WHY]
궁전 아래에 위치하던 집에는 몇 칸의 방이 있었는가?	5	[QUANTITY]
카라치올의 모유을 먹은 동물은?	사슴	[WHAT]
김두관의 해고를 반대했던 당은?	새천년민주당	[WHAT]
맥신이 상급 시험을 준비하던 학교는 어디인가요?	캐논 슬레이드 학교	[WHERE]
2019년 3월 정의용 안보실장과 접촉한 것으로 알려진 인물은?	존 볼턴 미국 NSC 보좌관	[WHO]
주노 탐사선의 소속 국가는?	미국	[WHERE]
후루카와 광업은 <창업100년사>이라는 간행물에서 광독을 어떤 단어로 바꾸어 표현하였나?	‘광해’(鉱害)	[CITE]
백색육에는어느 정도의 미오글로빈 색소가 내재되어있나?	0.05% 이하	[QUANTITY]
타지마할이 완공되기까지 걸린 시간은?	22년	[WHEN]
정부의 허가없이 여행 금지 국가를 여행시 처벌할 수 있는 조항이 명시되어 있는 법은?	《대한민국 여권법》	[CITE]
티모시 콜레토 다음으로 민유라의 요청을 받아 파트너가 된 사람은?	알렉산더 겜린	[WHO]
신존은 자신을 어떤 사람이라고 소개했는가?	평화주의자	[WHAT]
폴리비오스는 필로포이멘이 죽인 스파르타인의 수가 얼마라고 주장했나?	80명	[QUANTITY]
가타에에 등장하는 신을 표현한 언어는 무엇인가?	아베스타어	[WHAT]
포랭과 로트렉, 도미에의 공통된 성향은?	사회 비판	[WHAT]
단층은 만들어질 당시의 무엇에 따라 종류가 나뉘나요?	힘이 가해지는 방향	[WHAT]
로베르에게 도움을 청한 사람은?	교황 그레고리오 7세	[WHO]
데메트리오스가 전황을 타개하기 위해 투입했으나 실패한 병력은?	전투코끼리 부대	[WHAT]
인종에 따른 편향을 실험한 나라는?	미국	[WHERE]
알코올 의존증 환자가 술을 끊을 때 오한을 일으키는 물질은?	테트라하이드로 이소퀴놀란스	[WHAT]
눈물을 흘리며 정의를 살려달라고 청한 인물은 누구의 친구였나요?	조비	[WHO]
프로메테우스의 정의는 누구를 사랑하는 것인가요?	인간	[WHO]
북마케도니아의 공통 언어로 마케도니아어가 지정된 해는?	1991년	[WHEN]
사료 비판 중 실시 자체로 위서를 가릴 수 있는 방식은?	'진실성 비판'	[CITE]
긍정적인 생각을 부정적인 생각보다 선호하는 경향을 나타내는 용어는?	폴리애너 원리	[WHAT]
진원향교 통합 당시 장성향교의 소재지는 어디였는가?	장안리	[WHERE]
EU경쟁법의 시행 권리를 가진 기관은?	유럽위원회	[WHAT]
소련이 핀란드와 전쟁을 시작하며 처음 투입한 병력의 수는?	54만	[QUANTITY]
계몽 군주인 예카테리나 여제를 찬양하면서도 신하들의 아부나 가식을 풍자했던 송시는 무엇인가?	＜펠리사＞	[CITE]
레인보우 킥은 무엇이 무지개와 비슷해 만들어진 명칭인가?	공의 궤적	[WHAT]
니콜라오 2세는 누구의 도움을 받아 갈레리아를 정벌하였나?	노르만족	[WHO]
하인리히가 코냐크 동맹 전쟁에서 도움을 준 인물은 누구에 대항하고 있었나요?	프랑수아 1세	[WHO]
조에라트 철광산의 위치는?	서사하라 국경	[WHERE]
법원에서 상고 대상이 아닌 사건에 대해 상고를 기각하는 체계는 무엇인가요?	'심리불속행'	[CITE]
사벨이 겔구그와의 전투에서 파괴한 부위는?	오른 팔	[WHAT]
미국과의 협상에서 핵무기 대량 축소에 합의한 인물은?	고르바초프	[WHO]
정치적 무관심이 도움을 주기도 하는 요소는?	정치적 타협	[WHAT]
이무정이 황소의 난에서 공을 세워 임명된 관직은?	절도사	[WHO]
바리사이 파에게 순교당한 인물이 주교였던 곳은?	예루살렘	[WHERE]
김정길이 지역주의 제거에 선구하기 전 분위기를 조성한 사람은?	이효상 의장	[WHO]
솔라리는 어떤 사양을 쓰고있나요?	긴테쓰	[WHAT]
연꽃대좌에 앉아있는 불좌상이 입고 있는 옷은?	통견의	[WHAT]
음식 관리나 조리 과정에서 발생하는 문제로 인해 나타날 수 있는 질병은?	식중독	[WHAT]
몬태나와 와이오밍은 다코타 준주 지역으로 소속되었다가 언제 각각의 준주로 나뉘어졌나?	1868년경	[WHEN]
간부 양성 목적으로 설립된 시설의 이름은?	황푸 군사 학교	[WHAT]
2차 세계대전 당시 독일이 루프트바페 본부를 유치한 도시는?	파리	[WHERE]
자동차 산업에서 세척에 사용하는 재료는?	드라이아이스 펠릿	[WHAT]
김영희가 배구를 시작했던 도시는?	부산	[WHERE]
지우 일행은 전룡을 위한 약을 어디서 구했나?	진청시티	[WHERE]
쿠바에 살아서 도착한 반군 중 그들을 이끈 인물은 누구인가?	피델 카스트로	[WHO]
아라키돈산의 적정 섭취량은 1일 최대 얼마인가요?	1,500 mg	[QUANTITY]
1994년에 스페이스 명예의 전당에 오른 디지털 영상 처리 기술은 어떤 용도였나요?	의료용	[WHAT]
학생 지도부 회의 참석자 중 고려대학교를 다니는 사람의 이름은?	신계륜	[WHO]
마르크스는 착취계급이 어떤 계급을 상대로 착취했다고 주장했나요?	무산계급	[WHAT]
우간다 국민을 뜻하는 악기는?	북	[WHAT]
외교관과 함께 빨리 전쟁으로부터 대피시켜야 했던 사람들은?	민간인	[WHO]
1988년에 샤리아티는 파진 밀사이디를 만나기 위해 어디로 갔는가?	스웨덴 예테보리	[WHERE]
15살 때까지 맥신과 함께 살았던 인물은 어떤 직업을 가지고 있었나요?	시간제 간병인	[WHAT]
홍승대는 누구를 대신하여 동학군의 대장을 만나러 갔나요?	노은면의 부자였던 문중 형님	[WHO]
카포레토 전투 이후, 아르만도 디아츠에게 직권을 넘겨야 했던 인물은?	루이지 카도르나	[WHO]
윌리엄 3세가 보인강 전투에서 승리한 날짜는?	1690년 7월 1일	[WHEN]
해양지각이 맨틀로 돌아가는 과정을 뭐라하는가?	섭입	[WHAT]
박칼린이 <명성황후>를 편곡할 때 어느 나라에 있었는가?	호주	[WHERE]
에우데르 카마라가 대주교로 활동할 당시 민중 계몽에서 중시했던 요소는?	자존감	[WHAT]
보상제도에 있어 가장 기본이 되는 것은?	임금	[WHAT]
채상을 만들 때 사용하는 실을 칭하는 이름은?	물채	[WHAT]
범용 컴퓨터가 빨라지면서, 디지털 영상 처리 기술은 무엇의 역할을 대신하게 되었나요?	전용 하드웨어	[WHAT]
불가리아가 공산주의 국가로 전환된 해는?	1946년	[WHEN]
갈리아 키살피나를 이탈리아에 복속시킨 사람은?	율리우스 카이사르	[WHO]
미국과 달리 이민자 남성과 현지인의 결혼이 가능했던 국가는?	멕시코	[WHERE]
환어음에 관한 사항은 무엇을 바탕으로 작성된 것인가?	국제 상업 회의소의 신용장 통일 규칙(UCP)	[WHAT]
사회주의와 공산주의가 폭력 또는 비폭력을 통해 가지려는 것은 무엇인가?	정권	[WHAT]
음향효과 증대, 고전적 화성법 해체, 혁신적 화성 확대를 한 사람의 이름은?	바그너	[WHO]
왕망은 평제를 황제로 모시려 했을 때 평제의 생모를 어느 곳에서 지내게 하였는가?	중산나라	[WHAT]
용가리가 깨어나는데 계기를 제공한 사람은?	캠벨 박사	[WHO]
어리석은 사람 이야기는 어느 나라 이야기인가?	인도	[WHERE]
로디니아의 일부로 동남극 지역이 존재하던 시기는?	원생누대	[WHEN]
여운형이 김구에 의해 몸수색을 지시받은 장소는?	서대문 경교장	[WHERE]
다케다 역에서 스룻토 KANSAI 이전에 공용으로 쓰였던 승차카드는?	'J스루 카드'	[CITE]
가디너가 비용을 아끼기 위해 참고한 도시는?	시카고	[WHERE]
전투복 미착용을 이유로 견장을 사용하지 않는 사람은?	국방부 장관	[WHO]
6월 14일에 칼레바는 어디로 향하고 있었나?	헬싱키	[WHERE]
꼬리가 있는 도롱뇽과 달리 개구리는 분추류에서 갈라져 나왔다고 제시한 사람은?	로버트 L. 캐롤	[WHO]
이아손과 글라우케가 결혼한 지역은?	코린토스	[WHERE]
필리스 샐러바의 아들이 오하이오주 신시내티로 이주한 해는?	1900년	[WHEN]
미야니치 신문과 TBS가 실시한 여론조사에서 우위를 점한 당은?	제1야당인 민주당	[WHAT]
블루어-댄포스선과 영-유니버시티선이 분리되며 폐쇄된 곳은 어디인가?	아랫층 승강장	[WHERE]
경빈 박씨는 어떤 신분으로 궁에 들어오게 되었나?	흥청	[WHAT]
전원이 없어도 동작 가능한 장치는?	레일 브레이크	[WHAT]
<백유경>은 어느 나라의 고대 설화를 배경으로 만든 불교 경전인가요?	고대 인도	[WHERE]
레몽 4세의 아들이 죽은 해는?	1112년	[WHEN]
북쪽왕관자리 로 b와 지구 사이의 거리는 어림잡아 얼마나 되는가?	약 57광년	[WHAT]
곤막은 선우의 딸을 자신의 무엇으로 삼았나요?	좌부인	[WHAT]
긴 허리와 넓은 어깨의 장대한 신체는 어느 시대 불상의 양식인가?	임진왜란 이전의 조선전기	[WHO]
핀치 웨스트역 지붕에 사용될 색깔은 무엇인가?	녹색	[WHAT]
박근혜의 세종시 관련 주장을 듣고 당을 나가려고 했던 인물은?	홍준표	[WHO]
청주에서 일어날 반란을 미리 알게 된 이는?	복지겸	[WHO]
토끼가 거북이의 기분을 상하게 만들었던 거북이의 별명은 무엇인가?	느림보	[WHAT]
알렉상드린의 아빠는?	샤를 기욤 르 노르망 데티올	[WHO]
갈릴레오 갈릴레이가 쓴 책 중 출판으로 인해 감옥에 갇혔던 저서의 제목은?	〈천문학 대화〉	[CITE]
동틀녘에 햇살이 보이기 시작하는 순간을 뭐라고 부르는가?	파즈르	[WHAT]
핑크색 메르시는 무엇에 대한 사회적 인식을 깨우기 위해 한정적으로 출시되었나?	유방암	[WHAT]
광합성으로 남조녹말을 저장하는 조류는 어떤 생식을 하나요?	무성 생식	[WHAT]
Fire ant의 침에 있는 성분은 무엇인가?	솔레놉신	[WHAT]
닛폰 제지 후시키 공장이 폐업한 해는?	2008년	[WHEN]
일본이 전략물자를 몰래 빼돌려 거래했다는 확실한 증거가 있다고 주장한 인물은?	바른미래당 하태경 의원	[WHO]
유종이 조조에게 투항한 해는?	건안 13년	[WHEN]
윌란 반도 주변에서 일어난 전투의 이름은?	유틀란트 해전	[WHAT]
고구려에 협박하러 갔다가 연개소문에 의해 토굴에 갇히는 신세가 된 자는?	장엄(蔣儼)	[WHO]
예수가 출생한 장소는?	베들레헴의 한 동굴	[WHERE]
2010년 자신의 음반을 옹호하는 발언을 한 사람은?	가수 클라우스 마이네	[WHO]
선현전이 항복한 국가는?	한나라	[WHERE]
아라토스와의 클레오메네스 전쟁에서 패한 뒤 클레오메네스가 피신한 곳은?	이집트	[WHERE]
들뢰즈가 퀴비에-조프루아 논쟁을 해석한 철학적 입장은 무엇인가?	존재론의 차원	[WHAT]
사실주의와 자연주의가 영향을 받은 사조는?	텐류(流)의 실증주의	[WHAT]
국기 중앙에 자리잡고 있는 국장은 어디에서 따왔는가?	니콜라 1세 왕실기	[WHERE]
해변가 절벽에 자리잡고 있는 수도원에서 콤바인 포대를 공격한 인물은?	고든 프리맨	[WHO]
버몬트 주의 농부들이 가지고 있던 동물들을 팔았던 해는?	1860년	[WHEN]
긴급수급조정조치에 관한 법을 따르지 않을 경우 받을 수 있는 최대 벌금 금액은?	5000만원	[QUANTITY]
다양한 사회 대체 복무를 인정해주는 나라는?	프랑스	[WHERE]
영화 쉬리가 상영되기 전 최고의 흥행기록은 세운 영화는?	<타이타닉>	[CITE]
미사 본기도의 전통을 만든 것은 무엇인가?	교회	[WHAT]
린치에게 공격당하고 있다는 소식을 듣고 공화국군이 구조해주었던 집단은?	샤리에파	[WHAT]
왕온수에 대한 소문을 들은 무제가 부여한 직위는?	하내태수	[WHO]
경찰들이 시위대에 합류하면서 한 말은?	"""경찰과 국민은 하나"""	[CITE]
1984년 올림픽은 미국의 어느 도시에서 개최되었나?	LA	[WHERE]
셀루타의 남편은 누구인가?	르네	[WHO]
경기와 위황이 제거하려한 인물은?	조조	[WHO]
스튜어트를 구하러 온 부대는 어디에서 출발했나?	리틀 포크 교회	[WHERE]
위안스카이가 해임되기 전 지위는?	북양대신	[WHO]
비트겐슈타인이 오지에서 독거하며 써낸 작품은?	《논리 철학 논고》	[CITE]
디오메데스가 습격했을 때 레소스는 어디에 있었나?	자신의 막사	[WHERE]
포스카리의 재혼 상대는?	마리나 나니	[WHO]
헤라클레스가 살해한 인물은 누구의 혈연인가?	오이네우스	[WHO]
제로니모에게 저항을 그만하라고 설득한 사람은?	토벌대의 사령관 넬슨 마일스	[WHO]
섬이 침수되더라도 섬을 지키겠다고한 사람은?	윌리 텔라비 총리	[WHO]
고구려 정예부대원 수만명을 데리고 당으로터 압록강을 지키고 있던 인물은?	연남생	[WHO]
1876 민주당 전당 대회의 승리자는 누구인가?	새뮤얼 J. 틸던	[WHO]
감옥을 탈출한 인물이 담비에게 빼았겼던 것은?	대저택	[WHAT]
개신교 신학을 만든 세력은?	서방교회 개혁 찬성파	[WHAT]
프톨레마이오스는 알렉산더 제국을 통일하려는 사람을 누구라고 생각하게 되었는가?	안티고노스	[WHO]
이목에게 첫 싸움에서 가능한 빨리 승리하라고 지시한 인물은?	조왕 천(遷)	[WHO]
아르마니우스주의는 구원에 있어서 어느 사상과 비교되는가?	칼빈주의	[WHAT]
타지키스탄 요리는 어디의 음식과 비슷한가요?	페르시아 문화권	[WHERE]
당항포에서 왜군의 우두머리를 죽음에 이르게 한 무기는?	화살	[WHAT]
최초의 나무는 식물의 분류체계 중 어디에 속하는가?	양치식물	[WHERE]
올댓스포츠에서 황상민을 고소하려고 한 이유는?	명예훼손	[WHY]
탐관오리가 주도권을 가진 호해 시절 전에 황제였던 사람은?	진시황	[WHO]
김준연이 초등학생이 된 해는?	1908년	[WHEN]
한국군은 어떤 전략을 통해 7월 15일까지 북한군의 진격을 막을 수 있었나?	일련의 지연작전	[WHAT]
여러 부분으로 이루어진 심실을 가진 종은?	파충류	[WHAT]
ABC에서 방영되는 '시간이동'의 장르는?	텔레비전 드라마	[WHAT]
라마단 기간에서 동틀녘에 햇살이 보이기 시작하는 순간을 무엇이라고 하는가?	파즈르	[WHAT]
현재 미국으로 치즈를 운송할 때 사용되는 것은?	나무 상자	[WHAT]
루이 9세에게 무슬림에 대립하는 연맹을 결성하자고 제안한 인물은?	엘지기데이	[WHO]
찰스 2세의 뒤를 이어 왕위에 오른 자는?	동생 제임스 2세	[WHO]
녹명관의 주인처럼 행사하며 다양한 축제를 주최한 사람은?	이노우에	[WHO]
김경표가 민주당 활동을 시작할 당시 민주당 총재는?	김대중	[WHO]
대한제국의 군대 해산 후 황실 경호 업무를 맡게 된 것은 어디인가?	조선보병대	[WHERE]
참파가 비자야로 수도를 옮긴 해는?	980년	[WHEN]
김구와 김규식을 비난한 내용의 글을 보고 화를 낸 인물은?	한독당의 김학규(金學奎)	[WHO]
한 언어를 다른 언어로 번역하기 위해 필요하며, 의미론, 사전학, 화용론을 이해해야 하는 문법은?	구문론	[WHAT]
신탁통치 오보사건 당시 후견통치에 대해 반대를 하고 있던 집단은?	분단주의자(우익)	[WHAT]
아열대 전선과 극 전선 지대의 사이에 있는 전선은 무엇인가?	아남극 전선	[WHAT]
필명 세레스 에레오르로 출판돼 100만 부 가까운 판매고를 올린 책은?	'랑그라시아나의 밤'	[CITE]
코드링턴이 메메트 알리와 조우한 것은 몇 년인가?	1828년	[WHEN]
고구려가 지원군을 보냈고, 산성이라 당나라가 공성하기 어려웠던 성은?	신성	[WHAT]
러시아 의회의 하원을 이끄는 자는?	총리	[WHO]
시간이동' 에피소드의 다음 에피소드의 제목은 무엇인가?	거짓말	[WHAT]
위안부 피해자와 다른 여성들을 위한 사업에 쓰인 금액은 총 얼마인가?	6억여 엔	[QUANTITY]
각종 개혁을 실시했으나 결국 푸가초프의 난을 초래한 지도자는?	예카테리나 2세	[WHO]
교황 비오 11세는 이탈리아와 라테라노 조약을 맺기까지 얼마나 걸렸나요?	2년 반	[WHEN]
민제의 행차를 보고도 정체를 못 알아차린 사람은?	탕롱의 백성들	[WHO]
케네디와 존 매케인이 협력한 연도는?	2005년	[WHEN]
교회 개혁을 추진하는 사상은 무엇인가?	경건주의	[WHAT]
앤이 간략하게 재혼식을 거행하는 데 영향을 끼친 영국의 종파는?	성공회	[WHAT]
빌리 진 킹은 누구 덕분에 미국 대표단의 대표로 올림픽에 참가할 수 있었나?	미국 대통령 버락 오바마	[WHO]
땅 안에서만 생활하던 모울이 처음 마주하고 놀랐던 곳은?	강	[WHERE]
칭기즈 칸은 차가타이를 무엇이라 칭했는가?	야삭의 수호자	[WHAT]
독일이 우승했던 월드컵에서 전술과 선수 기용의 실패를 맛본 감독은 누구인가?	비센테 델 보스케 감독	[WHO]
리히노브스키 공작이 베토벤에게 주기적으로 제공한 돈의 액수는?	600 플로린	[QUANTITY]
와카마쓰의 본래 이름은 무엇이었나요?	구로카와	[WHAT]
미라형 변광성의 겉보기 밝기가 크게 변하는 이유는?	항성의 겉모습이 불규칙한 형태를 하고 있기 때문	[WHY]
15세기 불상들은 어느 시대의 계통이 이어져 온 것으로 추측되는가?	고려 후기	[WHEN]
김일성이 여운형의 암살을 지시했다고 주장한 사람은?	박갑동	[WHO]
강가이콘다 촐라푸람을 수도로 지정한 황제는?	라젠드라 1세	[WHO]
윤치호는 누구의 설교를 듣고 충격을 받았나?	남부 출신 남감리교회 목사들	[WHO]
안토니우스의 이목을 끌기위해 아그리파가 공격한 곳은?	그리스 해안가	[WHERE]
법화사가 모셨던 사람은?	양고리 장군	[WHO]
심청 이야기에 나오는 연꽃과 관련된 전설이 전해지는 곳은?	연화리	[WHERE]
유요를 곡아현에서 몰아낸 사람은?	원술	[WHO]
1990년 모든 사망 원인 중 25.8%를 차지한 병은?	심혈관 질환	[WHY]
새누리당이 반이 넘는 의석 수를 확보하게 된 것은 언제부터인가?	2008년 총선 이후	[WHEN]
다리우스 1세는 마케도니아를 정복한 후 누구를 신하로 삼았나요?	아민타스 1세	[WHO]
프랑스가 외규장각을 태우고 유물을 약탈한 원인이 되는 사건은?	병인박해	[WHY]
해침 시대에 생물량이 풍부하였던 장소는?	테티스 해	[WHERE]
스웨덴의 비르지타가 일찍이 스웨덴 왕실과 깊은 관계를 맺도록 기여한 인물은?	잉그보르그 벵츠도터	[WHO]
하레위'가 가리키는 것은?	레위 족	[WHAT]
작은 번에서 가로를 보좌하는 직책은?	요닌	[WHO]
최승희를 친일반민족행위 심의 대상자에 포함시켰으나 기각한 단체의 이름은?	친일반민족행위진상규명위원회	[WHAT]
이규완은 자신을 무엇이라 칭했는가?	아무것도 한 것이 없는 부끄러운 사람	[WHAT]
헬렌 모어는 어떤 무기를 이용하여 리 모건을 살해했나요?	총	[WHAT]
로렌의 땅은 언제부터 프랑스의 지배를 받았는가?	1766년	[WHEN]
교회 소유의 영토를 반환하기로 약속한 자가 사망한 해는?	756년	[WHEN]
김치인이 네 차례나 지낸 관직은?	영의정	[WHO]
오취도가 곤미가 된 후 거느린 백성의 수는?	4만여 호	[QUANTITY]
안나의 남편이었던 사람이 세상을 떠난 것은 몇년도인가?	1207년	[WHEN]
한국군이 지연전술을 펼쳤을 때 북한군은 어떠한 이유로 한국군에게 반격하지 못하였나?	산악지대에 걸쳐 분산되어 있기 때문에	[WHY]
마르티노가 교황일 당시 교황 즉위는 누구의 허가가 필요했나?	동로마 황제 콘스탄스 2세	[WHO]
인형사를 탄생시킨 것으로 추정되는 정부 기관은?	공안 6과	[WHAT]
현재 근로기준법이 과거에 비해 비교적 준수되어도 여전히 해결되지 못한 문제는?	비정규직 노동자들	[WHAT]
최초의 점성술 체계는 언제 등장했나요?	기원전 제2천년기	[WHEN]
제작술의 발전으로 회전대를 이용하고 광택을 낸 도기는?	흑색 토기	[WHAT]
ERG이론에서 근로자의 근무태도에 중요한 영향을 미치는 것은?	욕구충족	[WHAT]
정착하지 못하고 떠도는 이탈리아인들에게 붙여진 별칭은?	"""통행의 새들"""	[CITE]
일제강점기에 개최된 장치기 대회의 이름은?	‘우리 경기부흥의 봉화, 장구 얼레공대회 개최’	[CITE]
윌리엄 펜이 펜실베이니아를 식민지로 만들 수 있는 권한을 부여받은 연도는?	1681년	[WHEN]
초월적인 개념을 가진 단어와 구별되는 것은?	현존하는	[WHAT]
선양 역 고가대합실은 언제 처음 이용되었나?	2002년 11월 1일	[WHEN]
코고로의 대학후배가 죽은 채로 발견된 장소는?	홀 무대	[WHERE]
조고가 차기 승계자로 지정한 인물을 죽인 사람은 누구인가?	항우	[WHO]
무으타질라파가 최초로 알려진 곳은 어디인가요?	우마이야조	[WHERE]
1987년 이래 후쿠오카 아시아 영화제가 열리는 계절은?	여름	[WHEN]
조선로동당이 강동정치학원에서 온 유격대원들을 남쪽으로 보내며 만든 부대는?	조선인민유격대	[WHAT]
매니가 싸우다 나가 떨어지는 모습을 보면 발작을 일으키는 인물은?	마리아	[WHO]
송상현이 일본의 침입에 대비하기 위해 동래성 인근에 심었던 것은?	나무	[WHAT]
사촌 관계인 두 인물과 삼각관계에 처한 인물은?	주영걸	[WHO]
동로마 제국의 총대주교가 불가리아 총대교구를 정식으로 인정한 것은 어느 왕이 죽고 난 뒤인가?	시메온 1세	[WHAT]
제 3신분의 행동을 억압하기 위해 왕비가 내세운 것은?	왕명	[WHAT]
1989년에 가내작업반은 무엇으로 인정받게 되었나요?	사적기업설립권	[WHAT]
토성과 히페리온의 사진을 촬영한 우주선의 이름은 무엇인가?	보이저 2호	[WHAT]
내금강에 있는 절 중 제 모습을 유지하고 있는 절은?	표훈사	[WHAT]
나가시마 게이오의 마지막 경기와 겹친 행사의 주최 구단은?	주니치	[WHAT]
2016년 하계 올림픽 태권도 동메달 결정전에서 피에에게 패한 사람은?	스페인의 지저스 토르토사	[WHO]
대청누각이 특징인 곳의 인쇄판에 적혀있는 것은?	‘영춘헌’	[CITE]
기니피그에게 펠렛을 줄 때 제일 좋은 제품은?	옥스보우	[WHAT]
케트 이전 메스 게그러의 굳어진 뇌의 소유자는?	코날	[WHO]
벤 브라이얼리가 쓴 기념시는 어느 도시에 살던 침팬지에 대한 것이었나?	맨체스터	[WHERE]
일본이 평화선 철폐를 요구한 해는?	1963년	[WHEN]
이혼성이 청년 승려들을 비판했던 사건에서 다친 인물은 누구인가요?	강대련	[WHO]
호세 카레라스가 재단의 도움을 받아 병을 치료한 병원의 소재지는?	마드리드	[WHERE]
승무원이 이륙을 요청했을 당시 목표지로 설정한 곳은?	홍콩	[WHERE]
나중에 쌓은 산성의 길이는?	1,030m	[QUANTITY]
1997년 평화 협정 당시 러시아 측에서는 누가 사인했나?	보리스 옐친 대통령	[WHO]
던스터블 수도원에서 발견된 물건은 누구의 것으로 예상되는가?	리버리	[WHO]
19세기에 독일에서 수많은 아이들을 죽인 병은 무엇인가?	디프테리아	[WHAT]
인천상륙작전을 위해 사전에 감행된 경인지역 고립작전의 이름은?	크로마이트 작전	[WHAT]
민다나오 섬에 있던 사단 중 치안유지 임무를 맡았던 곳은?	제100사단	[WHERE]
간부회 인원을 선발하는 공식 기관은?	중앙위원회	[WHAT]
금호약효와 보응문성은 무엇을 확립한 화승인가?	마곡사파	[WHO]
한국 게임소설의 출발점이라고 할 수 있는 작품은 무엇인가?	《옥스타칼니스의 아이들(1999)》	[CITE]
탈북자들이 라오스를 경유하지 못하게 된 이유로 짐작되는 것은?	라오스 탈북청소년 북송 사건	[WHY]
로동 신문에 재등장한 공장에는 몇 개의 자동 가공 라인이 설치되어있나요?	16개	[QUANTITY]
고토 신페이가 제도부흥계획을 만든 이유는?	화재	[WHY]
공산당의 김구 정치자금 조달설과 관련한 규탄성명을 실은 언론은?	《동아일보》	[CITE]
조지 피켓의 여단을 지휘한 장교의 소식을 핸콕에게 전한 사람은 누구인가?	헨리 H. 빙엄	[WHO]
강제 수용소에 갔던 성직자들의 소속은?	케냐의 우간다 정교회	[WHAT]
루도비쿠스와 함께 왕위에 오른 사람은?	카를로마누스	[WHO]
진나라에서 부정부패를 일삼은 사람들은 누구의 권력을 탐냈나요?	황제	[WHO]
알비니가 전장에 나타나지 않은 것은 무엇 때문인가?	권력 갈등	[WHAT]
1977년부터 생 니콜라 뒤 샤르돈네 성당에서 주임 신부로 활동한 사람은?	라게리 신부	[WHO]
보너스 아미 중에서 1차 세계대전에 참여했던 사람의 수는?	17000명	[QUANTITY]
고인돌의 또 다른 이름은?	압하지야의 이른바 돌멘	[WHAT]
러시아에 공화정 형태의 임시정부가 수립되게 만든 사건은?	러시아 2월 혁명	[WHAT]
전조선축구대회에서 이영민과 라이벌 관계로 경기를 뛴 선수는?	김원겸	[WHO]
바빌론의 공중정원이 실존했는지 정확히 알 수 없는 이유는?	당대의 바빌로니아 기록들이 현재까지 별로 많이 남아있지 않기 때문	[WHY]
파시파에 그룹은 원래 무엇에 의해 쪼개진 소행성이었나요?	목성의 중력	[WHAT]
프레위디스는 누구의 동생인가?	레이프 에이릭손	[WHO]
암흑류 조짐이 차별화된 시공간에 있다고 말한 곳은 무슨 기관인가요?	NASA	[WHAT]
1543년도 미조노 종가의 당주가 묻힌 도시는?	미카와 국 다이주 사	[WHERE]
수탉은 누구에 의해 공개되었나요?	런던 시장 보리스 존슨	[WHO]
알레산드로 미켈레의 전임자는?	프라다 지아니니	[WHO]
치비타베키아와 라티나 역은 무엇으로 이어져있나요?	인터시티 철도	[WHAT]
그리스를 배반한 인물이 테르모퓔라이 습격을 돕기 위해 말해준 것은?	샛길	[WHAT]
위그가 라울로부터 물려받은 직위는 무엇인가요?	부르고뉴 공작위	[WHAT]
크레시 전투에서 대승을 거둔 군대는 누가 지휘했나요?	에드워드 3세	[WHO]
왕페이의 홍콩 콘서트장에서 더우웨이는 내내 어떤 악기를 연주했나?	드럼	[WHAT]
남조선노동당의 초대 부위원장은 누구인가?	박헌영	[WHO]
아자르야에게 패배한 아랍인들의 거주지 중 아자르야가 새롭게 성을 쌓은 지역은 어디인가?	블레셋	[WHERE]
후삼국을 통일하는 과정에서 훌륭한 군사적 역량을 보여준 자는?	혜종	[WHO]
독일 통일 이후 상당수의 트라반트를 대신한 것은?	서독제 차량	[WHAT]
망자와 함께 저승길을 동행하는 신선은?	동방삭	[WHAT]
보통 미사를 할 때 입는 것으로 등 부분에 큰 십자가 무늬가 있는 것은?	가즈라	[WHAT]
전쟁을 일으킨 당사자와 관련자들을 처벌하기 위해 거행된 재판이 열린 곳은?	뉘른베르크	[WHERE]
원각사가 있던 곳에 현재 있는 것은?	탑골공원	[WHAT]
《내 여동생이 이렇게 귀여울 리가 없어》는 어떤 문화와 관련된 작품인가요?	오타쿠 문화	[WHAT]
음실압의 환기시스템에서 틈새는 어디에 위치하고 있는가?	문 아래	[WHERE]
제6장갑사단이 어디로 가는 도중 소련군 증원부대와 마주쳤나요?	미시코바강	[WHERE]
동맹국과 협상국이 전쟁을 벌이게된 계기는?	오스트리아 황태자 부처의 암살 사건	[WHY]
오수전의 직전에 유통되었으며 구리로 이루어진 화폐는?	반냥전	[WHAT]
가족과 함께 뛰는 100m 달리기 시합' 에서 2등을 한 사람은?	소노미	[WHO]
오레스티스에 의해 살해당하기 전에 저주를 건 인물은?	클리템네스트라	[WHO]
이규완이 묻힌 도시는?	춘천시	[WHERE]
중국에서 언제부터 법으로 사유재산을 금지했는가?	2004년	[WHEN]
브라헤가 관측한 모든 행성들이 타원 궤도를 따라 운동함을 밝혀낸 자는?	케플러	[WHO]
이방희가 저격한 사람은?	임봉주	[WHO]
장면을 이 땅에 민주주의를 실현한 인물이라고 평한 사람은?	고려대학교 한국사학과 교수 조광	[WHO]
프리웨어의 이용 가격은?	무료	[WHAT]
프랑스 혁명이 일어난 시기는?	1789년	[WHEN]
웨이코 포위전 이전에 경찰들이 긴장했던 사건은 무엇인가요?	루비 리지 포위전	[WHAT]
바빌론의 공중정원이 사실 니네베에 있었다고 주장한 사람은?	학자 '스테파니 델리'	[WHO]
주민통제기능이 제대로 행해지지 않아 일어난 일은?	대규모 탈북사태	[WHAT]
1916년 경복궁에 있던 갈항사터의 탑들은 현재 어디에 소장되어 있는가?	국립중앙박물관	[WHERE]
실종자의 가족들은 배상급을 받는 것과 더불어 무엇을 요청하였나?	실종자에 대한 국가유공자 지정	[WHAT]
잉글랜드 요리는 어느 나라 요리에 속하나요?	영국	[WHERE]
캐나다의 대부분 지역에서 나타나는 기후는?	냉대기후	[WHAT]
예누파의 아이를 살해한 것은 누구인가?	코스텔니치카	[WHO]
유라쿠초선 사쿠라다몬역과 연결되는 지요다선의 역 이름은?	국회의사당앞역	[WHAT]
카얀데르의 두 번째 총리 임기기간은 며칠이었나?	135일	[WHEN]
코흐보다 4년 앞서 노벨상을 받게 된 인물은?	베링	[WHO]
괴살메는 어떤 동물과 비슷한 모양을 하고 있나요?	고양이	[WHAT]
야와타 쪽에서 들린 포성은 실제로는 누가 공격당한 것이었나?	오카야마・아노쓰 번	[WHO]
9년만에 스위스를 떠난 키르히너가 가고자 한 목적지는?	베를린	[WHERE]
아가타에게 종교를 배척하지 않으면 벌을 내리겠다고 협박한 인물은?	퀸티아누스	[WHO]
짜장면이 만들어진 도시는?	인천	[WHERE]
카르프러 리어타와 같은 사람이라고 추정되는 사람은?	"""레우다(Reuda)"""	[WHO]
모부투를 국방 장관으로 임명한 인물은?	루뭄바	[WHO]
샤를 6세의 정신 건강이 위태로운 상황이 되면서 권력을 되찾은 자들은 누구인가?	왕족	[WHO]
<두 벗(Les Deux amis)>는 어떤 집단으로부터 특히나 인기가 없었는가?	여성관객	[WHAT]
타지마할 건설에 쓰일 재료를 날랐을 것으로 추측되는 동물은?	코끼리	[WHAT]
고독사가 나타난 초반에는 주로 어떤 연령층이 발견되었나요?	중장년	[WHAT]
코르테스가 반항했던 대상은?	벨라스케스 도독	[WHO]
MLB 최초로 두명의 형제가 경기를 함꼐 뛴 날은?	1998년 9월 27일	[WHEN]
육사에서 무엇의 조건으로 태권도 단증이 필요한가?	졸업	[WHAT]
조소문화협회는 어느 나라에 속한 단체인가?	조선민주주의인민공화국	[WHERE]
브라질이 고무를 운반할 방법을 구상했던 년도는?	1867년	[HOW]
마가렛 매더슨의 조수 역할을 했던 사람의 직업은?	물리학자	[WHO]
손견을 죽인 사람의 목숨을 빼앗은 인물은?	손견의 부하 정보	[WHO]
불상조성기에서 제작기간은 언제라고 하는가?	조선 영조 6년(1730)	[WHEN]
원내대표 선거에서 정우택에게 패배한 사람은?	나경원	[WHO]
의정부법원의 판결로 구속 수감된 범죄자는 몇년도에 체포되었나?	2008년	[WHEN]
성서를 민중에 널리 알리기 위해 노력한 사람은?	존 위클리프	[WHO]
사람들은 명륜당에서 무엇을 하는가?	공부	[WHAT]
유메하라 노조미에게 편지를 전한 사람은 어디에서 활동하고 있나?	큐어 로즈 가든	[WHERE]
튀코 브라헤가 연구와 교육적 역할을 충실히 한 연구회를 만든 곳은?	Uraniborg	[WHERE]
중앙 정부로부터 임무를 받은 총독의 명칭은?	"""아리야푸트라"""	[CITE]
교황권으로부터 황제권의 자치를 논한 사람은?	단테	[WHO]
나들목 운영비에 대해 지방 자치법 위반을 지적한 것은 누구인가?	원주시의회	[WHO]
솔트레이크시티 국제공항을 중추 공항으로 사용하고 있는 항공사는?	델타 항공	[WHAT]
1949년에 결성된 비밀조직의 표면상 리더는 누구인가?	무하마드 나기브	[WHO]
마틸다와 결혼한 인물은?	벨프 5세	[WHO]
과육이 오랜지색인 멜론은?	캔털루프멜론	[WHAT]
스위스에 개신교를 전파하기 시작한 사람은?	츠빙글리	[WHO]
2015년 기준 1kW당 탄소배출량이 가장 낮은 재생 에너지원은?	풍력	[WHAT]
페우케스타스가 기원전 323년, 321년에 모두 태수로 유임된 지역은?	페르시스	[WHERE]
<노바라호>가 있던 함대의 지휘자는?	폰 페츠 제독	[WHO]
송문주를 위해 사당을 만들었다는 내용은 누가 작성하였는가?	채제공	[WHO]
다수의 왕국이 세워지고 무너지는 과정을 거치면서 스코틀랜드에 전하게 된 문화양식은?	켈트족 문화	[WHAT]
거대마젤란망원경의 관측 시작 가능 연도는?	2014년	[WHEN]
여야 중 신문과 방송의 교차소유를 반대한 쪽은?	야당	[WHAT]
원주민들이 스페인 사람을 꺼리게 만든 사람은?	알마그로	[WHO]
활나라를 망하게 한 진나라의 장수는?	백리시	[WHAT]
아인슈타인의 격렬한 비판 상대가 임종한 때는?	2001년	[WHEN]
브라헤는 태양이 어떤 행성을 중점으로 삼아 공전한다고 생각했는가?	지구	[WHAT]
대기이론은 생산활동의 3요소의 어떤 시간을 최소화시키는가?	유휴시간	[WHAT]
광운대 창립기의 시작 연도는?	1934년	[WHEN]
교황 선출에 황제의 동의가 필요하게 된 연도는?	824년	[WHEN]
크레딧 밸리 철도의 소유주가 바뀐 것은 언제인가?	1884년	[WHEN]
연희의 직업은?	임상심리사	[WHO]
강원도의 영서 지역과 영동 지역은 무엇을 기준으로 나뉘나요?	대관령	[WHAT]
손이 배에 붙어서 표현되어 있는 이유는 이것이 없었기 때문인데, 이것은 무엇인가?	팔	[WHY]
현대 도시 계획안은 도시계획의 어떠한 특성을 고려하기 시작하면서 탄생했는가?	복합적인 요소들의 상호작용과 메커니즘	[WHAT]
디즈니랜드는 사적인 이벤트를 위해서 어디에 바를 여는가?	공원	[WHERE]
진입장벽에도 불구하고 글로벌화 된 게임은?	포켓몬스터	[WHAT]
신민당을 흡수한 당을 만든 사람은?	김종필	[WHO]
스튜리지를 대신하여 주연 역할을 하게 된 배우는?	헤이든 크리스턴슨	[WHO]
곽상훈이 자신의 생각을 정리하여 얘기한 것을 무시해버렸던 집단은?	젊은 과격파	[WHAT]
귀상어의 동절기 서식지는?	열대 바다	[WHERE]
샤 자한의 관이 타지마할 전체에서 유일하게 대칭 구조를 띠지 않는다고 추측되는 이유는?	샤 자한이 이 무덤을 지을 때 자신이 그녀의 옆에 묻힐 것을 예상하지 못하였기 때문	[WHY]
서민호 전 의원을 정당의 공식 대표자로 내세운 정당은?	민주사회당	[WHAT]
전산학 발전 초기단계에서 아끼고자 했던 자원은?	CPU 시간	[WHAT]
오노미치 역 동쪽의 지리적 특성으로 붙여진 이름은?	"""비탈의 도시"""	[CITE]
스레드 플로트 게시판에서 스레드의 위치가 달라지는것 처럼 보이게 하는 것은?	댓글	[WHAT]
함경도 무산에 거주민의 탈북을 단속하는 집단은 무엇인가?	국가안전보위부	[WHAT]
미카일 3세는 언제 불가리아를 공격했는가?	864년	[WHEN]
본선에서 짐멜스톱을 이긴 사람의 출신국가는?	오스트레일리아	[WHERE]
소련 중앙위원회 서기국에서 일했던 사람들은 누구였나?	정치국원	[WHO]
윤치호가 조선이 문명국의 식민지가 되는 것이 낫다고 한 날은?	1890년 5월 18일	[WHEN]
장면에게 인사권 압력을 행사한 사람은?	이승만	[WHO]
소전제와 대전제에서 나타나는 제3의 개념을 무엇이라고 부르는가?	매개념(媒槪念)	[WHAT]
히틀러는 예를 들어 누구를 살 가치가 없는 생명이라고 했나?	정신장애인들	[WHO]
제1기병사단이 처음으로 전투를 했던 장소는 어디인가?	상주	[WHERE]
후안 왕자가 죽은 해는?	1497년	[WHEN]
윤치호가 감탄한 도로는 어떤 나라의 돈으로 만든 것인가요?	베트남	[WHAT]
마현 다산마을에서 출입을 통제하고있는곳은?	문도사	[WHAT]
니콜라스 2세가 왕위에서 물러나게 된 원인은?	페트로그라드에서 시위	[WHY]
간토 대지진으로 인한 사상자 수가 10만 5천명으로 수정된 연도는?	2006년	[WHEN]
이시다 겐타가 부상으로 이탈하기 전 마지막으로 치룬 경기는?	주니치 드래곤스전	[WHAT]
우에르타가 통치권을 가지고 있었을 때, 그를 옹호한 국가는?	독일	[WHERE]
고려시대에 거란이 쳐들어왔을 때 경상북도에서 간직한 물건은?	초조대장경	[WHAT]
사민당이 적녹연정을 이루기 위해선 어느 당과 연정을 구성해야 하는가?	녹색당	[WHAT]
강희제 배역을 맡아 이를 잘 표현한 중국 배우의 이름은?	천다오밍	[WHO]
꿈속에서 새뮤얼 러브맨은 누구에게 편지를 보냈는가?	러브크래프트	[WHO]
이명철이 사건을 저지른 날 하차한 지하철 역은?	수서역	[WHAT]
이호제가 통솔했던 부대가 거의 궤멸된 시기는?	1949년 12월 경	[WHEN]
단양 우씨 마을의 유래에 관한 사연이 있는 나무는?	남원 진기리 느티나무	[WHAT]
1923년에 일어난 지진은 무엇으로 인해 발생했었나요?	사가미 해곡의 미끄럼	[WHAT]
김계환이 마신 쌍화탕에는 무엇이 들어있었나요?	청산염	[WHAT]
명예 아리아인 호칭을 주는 임무를 맡은 나치의 기관은?	인종조사국	[WHAT]
교황 포르모소에게 기독교식 재매장이 허락된 것은 몇 년인가?	898년	[WHEN]
특정 관측값으로 천체의 위치를 계측할 수 있는 망원경은?	경위대식 망원경	[WHAT]
김동한 사망 2주기를 기리기 위한 좌담회에서 손지환은 어떤 역할을 했나요?	사회	[WHAT]
미드웨이 해전에서 일본 항공모함은 몇 대 소실되었나?	4척	[QUANTITY]
길리포스 장군에게 도움을 구한 곳은?	시라쿠사	[WHERE]
박상희는 누구에 의해 생을 마감했나요?	경찰	[WHO]
강병철이 한화 감독으로 임명 받은 해는?	1994년	[WHEN]
조선 초기 양식을 엿볼 수 있으며 나무로 만들어진 불상의 모델은?	아미타불	[WHO]
범인이 김태완군에게 부은 황산은 어디에 담겨져 있었나요?	검은 봉지	[WHERE]
효명세자의 예찰은 어디에 보관되어 있었나요?	양평군 친환경농업박물관	[WHERE]
1874년 귀국 이전 쓰보이가 머물던 국가는?	미국	[WHERE]
2014년 경리가 케빈, 소진과 함께 결성한 팀 이름은?	네스티네스티	[WHAT]
9번 교향곡과 마찬가지로 특정 표제가 없는 본 윌리엄스의 작품은?	교향곡 8번	[WHAT]
가족이 모두 뇌룡에게 죽임을 당할 당시 락인의 나이는?	8살	[QUANTITY]
신드바드의 당부로 검술을 배우게 된 인물은?	알리바바	[WHO]
벨기에의 차량 통행 방향은?	좌측	[WHAT]
군단병들이 전리품을 원하게 만든 요소는?	봉급	[WHAT]
월란정사가 있는 곳에서 생겨난 학문은?	도산학	[WHAT]
대통령의 간접 선거 기능을 맡았던 곳이 만들어진 해는?	1972년	[WHEN]
호조로 명칭이 확정된 때의 임금은?	공양왕	[WHAT]
혜산시의 전용 역은 누구를 위한 것인가?	김정일	[WHO]
클리리타임네스트라는 어느 나라의 공주였는가?	스파르타	[WHO]
스미토모 오사카 시멘트 전용선의 운행이 중단된 시기는?	2002년 9월	[WHEN]
베로브킨 장군의 뒤를 이어 명령권을 가진 사람은?	대령 미하일 스코벨레프	[WHO]
오래플린이 부스와 대통령 납치에 대해 얘기하기 위해 방문한 식당은 어디에 위치하는가?	펜실베이니아 가	[WHERE]
바둑tv를 운용하면서 바둑이 스포츠로 인정받게 만들기 위해 노력했던 회사는 어디인가?	온미디어	[WHERE]
로타르 2세와 발트라다의 결혼은 언제 무효화되었는가?	869년	[WHEN]
다섯 명의 선우가 난립하게 된 해는 몇 년인가?	기원전 57년	[WHEN]
husroum (حصروم)을 페르시아어로 번역하면?	ab-ghooreh	[WHAT]
긴테쓰 구단은 퍼시픽 리그에서 몇 번 우승했나?	4번	[QUANTITY]
윤치호가 조선에서 탄생한 위대한 인물이라 칭하며 극찬을 보낸 인물은?	다산 정약용	[WHO]
클로스긴팔원숭이는 어디에서만 생활하고 있나요?	수마트라 섬 서부에 있는 믄타와이 제도	[WHERE]
닌자도의 크기와 모양이 사무라이가 사용하는 도검과 다른 이유는?	휴대성을 향상시키기 위해	[WHY]
테드 크루즈 의원과 다이앤 파인스타 의원 사이의 논쟁은 무엇에 관한 것이었나?	중국의 인권 문제	[WHAT]
솔 밤바의 수비형 미드필더로서의 기량을 칭찬한 사람은?	파텔란	[WHO]
경성제국대학원의 교수와 교직원의 국적은 주로 무엇이었는가?	일본인	[WHAT]
뇌전증 발작은 어떤 세포의 기능적 문제로 발생하는 증상인가요?	뇌피질세포	[WHAT]
하탸야 중위가 니도로 섬 동부에 상륙할 당시 이용한 보트는 어느 부대 소속인가?	선박 공병 제24 연대	[WHAT]
합성세제의 폐액 때문에 발생하는 문제로 미생물을 죽게 만드는 요인은?	산소부족	[WHY]
의식의 전단계로 무의식을 빼내어 의식으로 바꾸는 것은?	전의식	[WHAT]
러시아의 조치를 제재하려한 세력은?	미국을 비롯한 서방	[WHAT]
남종삼이 사망할 당시 유일하게 살아남은 인물은?	둘째 아들	[WHO]
아케메네스 제국의 금 가공술을 전통으로 이어받은 나라는?	페르시아	[WHERE]
가쓰라 내각에 해군 대신으로 임용된 사람은?	사이토 마코토	[WHO]
리세균이 두 번째로 옥살이를 한 곳은 어디인가?	대전형무소	[WHERE]
할릴자드가 이라크 헌법 비준 허용 협상을 도운 연도는?	2005년	[WHEN]
박지성이 독일과 멕시코의 경기에 대해 설명했던 방송국은?	SBS	[WHERE]
신노스케가 속한 조직은?	카스카베 방위대	[WHAT]
권진이가 자신의 문제를 깨달은 후 신을 위해 무엇이 되기를 결정했는가?	순교자	[WHAT]
김집이 부여에 부임한 이후 가장 먼저 지원한 기관은?	학교	[WHAT]
하정완이 본격적으로 영화설교를 시작한 해는 언제인가요?	1999년	[WHEN]
대한기계학회에서 '피로의 통계학적 분석'이라는 제목으로 춘계학술강연이 열렸던 해는?	1972년	[WHEN]
지구를 모두 돌 수 있는 단 하나의 해류는?	남극 환류	[WHAT]
라쉬를 반여성주의자라고 칭했던 인물은?	Susan Faludi	[WHO]
국내특급우편 취급지역 외 지역으로 우편물을 보낼때 해당 우체국에서 전달할 사람을 정해서 배달하는 제도는?	특사배달	[WHAT]
테크모델철도클럽에서 두 번째 그룹이 한 연구는 무엇에 관한 것이었나?	기차끼리 서로 부딪히지 않도록 제어하는 것	[WHAT]
금적보 공격을 성공시키고 마화룡을 죽인 사람은?	유금당	[WHO]
안티오코스의 영토 장악 야망이 가로막힌 계기가 된 사건은?	〈라피아 전투〉	[WHY]
푸들이나 비숑 프리제처럼 개 알레르기 반응을 거의 일으키지 않는 동물 부류는 무엇인가?	저자극성 동물	[WHAT]
프리타코사우루스의 위석은 모래주머니에서 발견되기도 하지만 가끔 어디에서 발견되나?	복강	[WHERE]
이길여가 환자들을 놀라지 않게 하기 위해 가슴에 품고 다녔던 물건은?	청진기	[WHAT]
고롯케(코롯케)는 원래 어느 나라 음식인가?	프랑스	[WHERE]
케냐타가 3번째 혼인을 치른 것은 몇년도인가?	1946년	[WHEN]
큰긴코박쥐가 가루받이를 돕는 식물은?	청용설란(Agave tequilana)	[WHAT]
리우네자네이루에서 개최된 세계선수권대회의 준결승전에서 크르팔레크를 상대로 승리를 거둔 선수는?	흐롤	[WHO]
부상을 입어 힌스키에 의해 대체 된 선수는?	클리프 플로이드	[WHO]
만주보민회의 주활동지는?	남만주 지역	[WHERE]
듀이가 첫 번째로 뉴욕 주지사가 된 해는?	1942년	[WHEN]
보로메오에게 특무성 장관직을 맡긴 인물이 교황으로 선출된 년도는?	1560년	[WHEN]
『금쇄동기』에서 어떤 유형의 문학 작품을 읽을 수 있나?	한시	[WHAT]
비트겐슈타인의 누나의 피아노 선생님은 누구인가?	요하네스 브람스	[WHO]
신토마스 주의가 한계점을 말한 대상은?	근대철학	[WHO]
러셀은 1889년에 파리 박람회를 방문하여 어느 곳을 다녀왔는가?	갓 건축된 에펠 탑	[WHAT]
오늘날 역사적인 장소로 알려진 곳은?	월머 해안	[WHERE]
언필드 문화에서 낫은 무엇과 비슷하게 생겼나요?	초승달	[WHAT]
음낭의 또 다른 명칭은?	낭심	[WHAT]
삿포로 올림픽이 열렸을 때 어디를 주요 회장으로 사용했나?	마코마나이 공원	[WHERE]
줄리안 어산지가 IS의 배후 인물이라고 주장한 사람은?	힐러리 클린턴	[WHO]
대통령 임기가 끝나고 배우가 되려는 사람은?	체임버스	[WHO]
조작설의 근거가 되는 물건은?	각종 수신(受信) 문서들	[WHAT]
암컷 애애미 무늬의 색은?	녹색	[WHAT]
외부에서 성곽으로 향하는 시계를 차단하고 있는 것은?	산림	[WHAT]
차티스가르 지역의 우익 민병대의 행동은 헌법에 위반되는 행위라고 인도 대법원이 선고한 날은?	2011년 7월 5일	[WHEN]
일본에서 검찰심사원으로 활동한 경력이 있는 인원 수는?	총 54만명	[QUANTITY]
팔랑크스는 누구의 동방 원정에서도 효과적으로 쓰였나요?	알렉산드로스 대왕	[WHO]
1956년에 워너가 사기친 인물의 이름은?	해리	[WHO]
가혹한 노동에 대해 국제적으로 규제하고 있는 단체는?	ILO	[WHAT]
행정을 13도로 지정하고 황제의 권위를 높인 인물은?	태황제	[WHO]
피터와 로렌바움이 하이든의 머리를 대신해 귀족에게 준 것은?	다른 노인의 시체의 머리	[WHAT]
셰이크볼의 속도는 어느 정도 인가?	80 km/h	[QUANTITY]
질량이 비슷한 2개의 별이 쌍성계를 이루고 있을 때, 이 쌍성계의 질량 중심은 어디인가?	두 별 사이의 공간	[WHERE]
겨울에 아시아 대륙 내부에서 나타나는 고기압부의 중심이 되는 지역은 어디인가?	고비사막	[WHERE]
영국은 어떤 이유로 공해에서 바다로 유입되는 모든 선박을 막았나?	중립국 선박에 피해를 입히는 것을 막기 위해	[WHY]
모투부가 1959년에 다시 방문한 곳은?	브뤼셀	[WHERE]
당나라는 고구려의 신성을 언제 점령했는가?	667년 9월	[WHEN]
김집이 몸이 아파서 내려놓은 관직은?	부여현감(扶餘縣監)	[WHO]
봉헌 생활회를 감독하고 관리하는 기관은?	교황청 기구인 수도회성	[WHAT]
아제르 상귀니스를 아람어로 하면?	아켈데마치	[WHAT]
기원전 227년에 군사혁명을 일으켜 에포로스를 살해한 인물은?	클레오메네스	[WHO]
호출에 의해 동적인 상태로 변환되는 소프트웨어 구성요소는?	소프트웨어 모듈	[WHAT]
합당한 이치에 따라 비현실적인 개체가 등장하는 것은 무엇인가?	판타지	[WHAT]
스코틀랜드 계몽주의자들은 개인과 사회가 함께 발전할 수 있는 것은 어디에서 덕을 기를 때라고 믿었나?	현실의 경험속	[WHERE]
요나미네에게는 야쿠자의 어떤 행동이 트라우마로 남았는가?	협박	[WHAT]
법치국가에서 국민의 처벌 근거를 증명해야하는 기관은?	법원	[WHAT]
8명 이상의 노동자를 고용하여 영리활동을 하는 경제조직은 언제 이후부터 출현하였나?	1978년	[WHEN]
잔류 러시아인이 러시아 빵을 판매한 지역은?	가라후토	[WHERE]
1895년에 서재필이 숨어있던 곳은?	언더우드 박사 집	[WHERE]
철도공으로써 받은 첫 급여로 파브르는 무엇을 구매하였나?	벌레와 꽃, 그리고 새들을 노래한 시집	[WHAT]
모린의 남자친구가 있는 곳은?	오만	[WHERE]
반야월이 어디로 향하던 중에 농부 부부처럼 보이는 남녀의 이별 장면을 보게 되었나?	제천	[WHERE]
프로비던스 건담을 터뜨린 것은 무엇인가?	제네시스로부터 발사된 감마선 레이저	[WHAT]
남진과 함께 대중가요의 발전 원인이 된 사람은?	나훈아	[WHO]
오다와라 역 11번 타는곳에 서는 열차는 몇 량인가?	4량	[QUANTITY]
궁예가 석총을 살인할 때 사용한 무기는?	철퇴	[WHAT]
영명사는 어떤 사건으로 인해 소실되었나?	한국 전쟁	[WHAT]
1970년대 여성운동가들이 차별받는 여성을 비유한 대상은?	생태계	[WHO]
1997년 일본 시리즈 우승팀은?	야쿠르트	[WHAT]
양회와 강절에서 산서시들과 경쟁을 한 집단은?	휘주상인	[WHAT]
옛 대한제국의 황제 집안과 관련된 직무를 맡은 관청을 무엇이라 부르는가?	이왕직	[WHAT]
메디아인이 자그로스 산맥에 정착을 시작한 시기는 철기 시대 제 몇 기인가?	제1기	[QUANTITY]
페뷔스가 에스메랄다를 변호하지 않은 것은 누구 때문인가?	약혼녀 플뢰르 드 리스	[WHO]
피터 클리포드가 마야단의 시골이 공격받고 있음을 알린 날은?	8월 9일	[WHEN]
강재구 소령을 살해한 무기는?	수류탄	[WHAT]
배우 문예봉이 여주인공으로 활약한 영화는 무엇인가?	《군용 열차》	[CITE]
레닌은 누가 정권을 잡아야한다고 생각했나?	프롤레타리아	[WHO]
견인상태에서 사격상태가 되는데 시간이 많이 소요되는 것은?	차바퀴가 달린 대포	[WHAT]
희망의 당에게 자신의 당과 연합할 것을 제안한 인물은?	마에하라 세이지	[WHO]
헨리 모건소가 오스카 스트라우스와 같은 직위를 받은 것은 몇 년인가?	1913년	[WHEN]
지구와 화성만한 천체의 충돌로 만들어진 위성은?	달	[WHAT]
자격 없는 대통령을 대신하여 부통령이 대통령 임기를 수행하도록 하는 내용은 미국 헌법의 어떤 부분에 나와있는가?	20차 개정헌법 3절	[WHAT]
플로리다가 영국 영토가 된 것은 언제인가?	1763년	[WHEN]
바젤이 위치한 국가는?	스위스	[WHERE]
남한군의 도망을 방해한 것은 누가 설치하였나요?	응오꾸옌	[WHO]
브룸/예튼/제이고 이론은 단기간 학습을 통해 어디에 적용할 수 있나?	현실	[WHERE]
고구려 연맹장들이 세력을 키우고 집권화하는 데 중요한 역할을 한 도구는?	철기	[WHAT]
이탈리아 수석 대주교의 직함 중 없어진 것은?	서방 총대주교	[WHAT]
1479년 아라곤의 왕위를 계승한 인물은?	페르난도 2세	[WHO]
호프만스탈의 사망 원인은?	뇌출혈	[WHY]
각진국사가 주변 주민들을 돕기 위해 심은 것은?	비자나무	[WHAT]
존재에 대해 의심하는 순간, 존재를 증명하는 것은?	사고	[WHAT]
지온 군의 강하 작전 때 지구상의 연방군이 쓸 수 없게 된 것은?	레이다	[WHAT]
홈 네이션스와 같은 말은?	컨트리(country)	[WHAT]
플레이어와 블레이드가 알두인에 맞서 싸울 수 있는 힌트를 얻은 장소는?	스카이 해븐 사원	[WHERE]
석조 보살좌상에서 신체의 밑부분 보다 크다고 느껴지는 것은?	상체	[WHAT]
처녀는 물에 무엇을 띄어 왕건에게 주었나요?	버들잎	[WHAT]
공릉천이 합류하는 하천은?	한강	[WHAT]
불염포에 싸여 있는 곳은 무슨 악취가 나는가?	동물 사체	[WHAT]
야마가타 이자부로에게 독립선언 사실을 알린 사람은 모두 몇 명인가?	29	[QUANTITY]
골더스그린역 기준으로 헨든 센트럭역이 위치한 방향은?	북쪽	[WHAT]
삿사 나리마사가 엣추국을 성장시키는데 기반으로 삼은 산업은?	농업	[WHAT]
성매매 종사자가 계약에 묶일 필요없이 언제든 그만 둘 수 있음을 의미하는 말은?	자율적 결정	[WHEN]
대한민국 임시정부가 김성수에게 내어준 자리는?	임정 국무위원(장관급)	[WHAT]
사이클롭스는 어떠한 몬스터로 분류되는가?	대형 몬스터	[WHAT]
보조 수트 액터를 맡은 사람은?	나카지마 하루오	[WHO]
마사키가 라기아스에 남을 수 있었던 이유는?	지상에 가족이 없었기 때문	[WHY]
정병국이 집행유예를 받을 수 있게 도움을 준 것은 누구인가?	민주화추진협의회 소속 변호사	[WHO]
미키 카즈마가 중요시한 캐릭터의 특징은?	전면적으로 자리잡힌 임팩트	[WHAT]
소론의 우두머리를 맡은 인물의 아버지는?	윤선거	[WHO]
독립채산제의 확대 실시 등으로 이루어진 경제 관리 개선 조치를 무엇이라고 하는가?	경제개혁조치	[WHAT]
블랑카의 전기를 빼앗으려한 인물은?	베가	[WHO]
진시황이 즉위하기 전에는 어느 나라의 천자가 유일하게 왕이 될 수 있었나?	주나라	[WHERE]
톰홀츠가 언제 책에서 티타노케라톱스의 동물이명에 대해 언급했나요?	2012년	[WHEN]
2001년 포이즌 필 규정을 채택한 회사의 지분을 두 번째로 많이 소유한 곳은?	광주은행	[WHERE]
혜경궁 홍씨의 저서는?	《한중록》	[CITE]
1969년 공화주의 스파르타크 경연 대회에서 킴의 성적은?	우승	[WHAT]
컴퓨터 플랫폼 중 가장 유명한 것은?	x86 아키텍처에서 수행되는 마이크로소프트 윈도우	[WHAT]
자신의 병사를 지키며, 적군의 사기를 떨어뜨릴 수 있는 공격 방법은?	수공	[WHAT]
레온나토스가 측근 호위관이 된 연도는?	기원전 331년	[WHEN]
센트럴 런던으로 출근하는 사람들 중 자차를 이용하는 사람의 비율은?	11%	[QUANTITY]
동키의 발명품의 명칭은?	'수면 학습기'	[CITE]
무인은 언제부터 일국동량의 명령을 받기 시작했는가?	11세기	[WHEN]
노동 시장 안의 현상들을 학문화할 수 있었던 기반을 다지기 시작한 시기는?	20세기 초반	[WHEN]
메흐메트가 이탈리아를 침략한 이유는?	자신이 로마 제국의 황제의 계승자라고 굳게 믿었기 때문	[WHY]
유엔 인구 기금은 누구를 만날 때 7개의 규칙을 따르라고 하였나?	치료 중인 산부인과 환자들	[WHO]
도조 히데키는 누구의 죽음 이후에 통제파의 주요 인물이 되었나요?	나가타	[WHO]
마사카타의 시체가 고사카 산에 묻히기 이전에 있었던 곳은?	고마루 산	[WHERE]
그레고리오를 라테리노 궁전에 가둔모임은?	선거인단	[WHAT]
경제적 이유로 다시 창을 무기로 사용한 국가는?	폴란드	[WHERE]
프시타코사우루스의 얼굴에서 유일하게 다른 파충류와 다른것은?	두개골의 눈구멍과 콧구멍 사이에 있는 전안와창	[WHAT]
나무다리의 한계를 대체하기 위해 만든 것은?	돌다리	[WHAT]
쇼군 직속가신단 중 쇼군을 직접 만날 수 있는 무사는?	하타모토	[WHAT]
유영 대신 황태자가 될 뻔한 인물은?	장자 유비(劉肥)	[WHO]
닉슨 행정부가 출범한 시기는?	1969년 1월	[WHEN]
20세기 이후에 함대 통보함의 임무를 대신하는 것은?	구축함	[WHAT]
치천나라가 건립된 해는?	문제 16년(기원전 164년)	[WHEN]
러일 전쟁의 승전국은?	일본	[WHERE]
역대 로마의 왕들 중 가장 먼저 포룸 로마눔에서 베스타 여신을 섬기는 의식을 치른 왕의 이름은?	누마 폼필리우스	[WHO]
실외에서 하는 농구 경기를 무엇이라고 하는가?	'거리 농구'	[CITE]
타르 연주자가 음을 결정하기 위해 손을 대야 하는 것은?	현	[WHAT]
주제 사라마구가 반종교주의자라며 비판한 곳은?	로마 가톨릭 교회	[WHERE]
열대 파동으로부터 제 8호 열대저기압이 생겨난 날짜는?	8월 23일	[WHEN]
송우석이 인권 변호사로 활동하게 된 계기는?	부산 학림사건 변호	[WHY]
남성 노동자들은 누가 중국 남성들의 미국 이민을 거부하길 바랐는가?	의회 의원	[WHO]
외교 사절단이라는 함정을 이용해 프리츠 황제를 암살하고자 한 집단은?	마레	[WHAT]
2차 컨스타운 전투 당시 브레킨리지는 누구의 휘하에 있었나?	주벌 얼리 장군	[WHO]
알렉산드로스 대왕은 고대 근동을 언제 점령했는가?	기원전 4세기	[WHEN]
광종이 혜거를 만나러 도덕암에 갈 때 이용했던 이동수단은?	어가	[WHERE]
로빈훗과 필립 왕세자가 만난 곳의 지명은?	셔우드 숲	[WHAT]
돈오점수와 혜능의 법맥은 양립할 수 없다고 주장한 사람은?	성철	[WHO]
나폴레옹이 크렘린 궁을 불태운 것은 몇 년인가?	1812년	[WHEN]
모하베드 나부스의 아내는?	삼라 나부스	[WHO]
알렉산더 3세를 자신의 사위로 맞고자 했던 할리카르낫소스의 지배자는?	피크소다로스	[WHO]
은평공원의 김용원 유적비에 이돈직의 공적이 새겨진 사실을 찾아낸 인물은?	김옥경	[WHO]
군 징집을 면제받은 인물이 1차 세계대전 당시 옮겨간 지역은?	크라쿠프	[WHERE]
5종의 단공류 중 네가지의 종류를 차지하는 동물은?	가시두더지	[WHAT]
조스마의 나이는 약 몇 년으로 예측되는가?	5억 년	[WHEN]
레코드와 Nullable 참조를 조합하여 나타내는 자료구조는?	연결 리스트	[WHAT]
<발굴추척, 어느 삼형제의 선택>이 방영된 날은?	2018년 8월 13일	[WHEN]
서방의 진출로 파생된 십자군운동이 중세의 어떤 제도를 해체시켰는가?	봉건제	[WHAT]
컴퓨터와 통신망으로 이루어진 새로운 도시건설 계획은 어느 지역에서 마련하는 중인가?	캘리포니아 주	[WHERE]
경기장에 있는 특별 지정 구역은 누구를 위한 것인가?	게스트 팀 팬	[WHO]
윌리 딕슨의 블루스 천국이 개장된 년도는 언제인가요?	1997년	[WHEN]
빌게이츠가 8800 컴퓨터의 값 하락에 대해서 알게 된 글은 언제 발행되었나요?	1975년 1월	[WHEN]
거대도시에서 가족의 해체, 각종 범죄, 정신적 질환 등이 특별히 많아지는 것은 무엇이 충돌되기 때문인가?	가치기준	[WHAT]
부인과 수도사가 밀회를 하는데 걸림돌인 사람은?	남편	[WHO]
1966년 처음으로 운행된 베이역은 블루어에서 어디까지 운행되었나?	댄포스선	[WHERE]
제11장갑사단이 우회시킨 부대는?	전차부대	[WHAT]
함경북도에서 유일하게 철도가 없는 군은?	화대군	[WHAT]
윤세주가 교관을 맡았으며 민족혁명당 규모 확대에 이바지한 학교는?	중앙육군사관학교 성자분교	[WHERE]
최초로 영국 아카데미 외국어 영화상을 받은 한국 영화는?	《아가씨》	[CITE]
보현암 석조관음보살의 보존 상태는 어떠한가?	양호한 편	[WHAT]
아달베르트의 부친이 돌아가신 해는?	943년	[WHEN]
천안군당의 사상은?	사회주의	[WHAT]
반민특위에 체포되고 60년 후에 안인식이 오른 명부는?	친일반민족행위 705인 명단	[WHAT]
핏소니아 로퀴애가 사냥하는데 이용하는 것은?	도깨비 방망이를 닮은 줄기	[WHAT]
다양한 양조 방법이 설명되어 있는 가장 오래된 문헌이 발견된 곳은?	수메르	[HOW]
돌궐제국을 건국한 이후 소그디아나에 생긴 변화는?	튀르크화	[WHAT]
이스라엘의 유일한 여왕의 손자는 누구인가?	요아스	[WHO]
파이드라의 남편은 누구인가?	테세우스	[WHO]
천황이 대국민 메시지에 대한 원고 작성을 완료한 날짜는 언제인가요?	3월 16일	[WHEN]
안나 네다의 오빠는 어느 나라의 임금인가?	세르비아	[WHERE]
타지키스탄 지역에서 인기가 가장 많은 요리는?	카불리 풀라오	[WHAT]
3당 합당을 겪은 정당 중 군사정권에서 책임이 있는 당은?	민정당	[WHAT]
무굴의 그림은 어느 국가의 양식을 이어받았는가?	페르시아	[WHERE]
소문에 의하면 1887년 4월 20일의 행사에서 어떤 사건이 일어났는가?	정부 고관들의 부녀 폭행	[WHAT]
민간에서 전해지는 바에 의하면 궁예는 누구와 대적하다 죽었는가?	왕건	[WHO]
계필하력을 특별히 아꼈던 왕은?	당 태종	[WHO]
런던에서 큰 화재가 일어났던 당시 제임스 셜리는 어떤 직업을 가지고 있었나?	극작가	[WHAT]
브리튼 섬에 독립 세력을 확립하고 왕국을 건설한 이들은?	앵글로색슨 용병단	[WHAT]
로마군을 상비병으로 만든 인물은?	가이우스 마리우스	[WHO]
테오도르 뒤부아가 받기를 거절한 상은?	모리스 라벨의 로마대상	[WHAT]
이윤필의 아버지는 누구인가?	이기혁	[WHO]
블룸필드의 전공은 무엇인가?	게르만어파 역사언어학	[WHAT]
하늘의 남극 방향을 찾을 수 있게 해주는 별은?	남십자성	[WHAT]
노랫말의 번역이 대구 시구 번역보다 훨씬 제약이 많은 이유는?	형태에 있어 거의 혹은 전혀 자유가 없어 다양한 번역을 창조해내기가 불가능하고 시구 구조에서도 다른 여지를 찾기 어려운 탓이다.	[WHY]
이집트의 통일 당시 티니스 왕족에 합쳐진 왕족은?	네켄의 왕족	[WHAT]
이민자들이 필요로 했던 것은?	토지	[WHAT]
의사소통이 잘 안되거나 여행이 연기, 혹은 취소된다고 해석하는 경우는?	수성의 역행	[WHAT]
웅게른슈테른베르크가 포로로 붙잡혔던 유격대의 리더는 누구였나요?	표트르 슈체틴킨	[WHO]
67년에 데뷔 싱글을 낸 밴드는?	소프트 머신	[WHAT]
중세 사람들의 상상력을 자극한 창의 주인은 누구인가?	롱기누스	[WHO]
총학에서 노동자의 인권에 관한 내용을 기반으로 협의하여 정한 규칙은?	학생규약	[WHAT]
수지는 오목이를 누구와 결별시켰는가?	인재	[WHO]
통진당의 행보를 비판하고 해산을 주장한 사람은?	청구인(정부)대표 황교안 법무부 장관	[WHO]
전체 중 일본의 매출이 40%인 회사는?	알서포트	[WHAT]
이베이에서 페이팔로 결제가 가능한 것은 언제까지인가?	2023년 7월	[WHEN]
다카기 모리미치가 50개의 도루를 기록해 도루왕 타이틀을 받았던 해는?	1963년	[WHEN]
예수가 아닌 다른 메시아의 등장을 바라고 있는 사람은?	유대인	[WHO]
산악 포병 연대 발령 당시 비트겐슈타인의 계급은?	대위	[WHO]
보닌의 처형 방식이 캘리포니아주의 치사 주사로 변경된 해는 언제인가요?	1992년	[WHEN]
히로시마를 누르고 우승을 차지한 팀은 어디인가?	세이부 라이온스	[WHERE]
독일 연방의 맹주 국가에서 혁명이 발생한 시기는?	1848년	[WHEN]
르네상스 시대에 세례대를 관리하던 곳의 명칭은?	세례당	[WHAT]
원작자가 주인공을 결정한다고 주장한 사람은?	연출자	[WHO]
6개국에서 1등을 한 음반이 출시되었던 해는?	1970년	[WHEN]
피배서인이 행사할 수 있는 권리의 범위는?	어음상의 모든 권리	[WHAT]
중등교육이 의무적으로 처음 시행된 곳은?	도서벽지지역	[WHERE]
보다폰은 누구를 후원하는가?	페라리	[WHO]
창구가 운영되는 시간에 역무원이 직접 표를 검사하는 역사는?	싯테 역	[WHAT]
가정맹어호와 관련된 동물은 무엇인가요?	호랑이	[WHAT]
새누리당의 무상급식 관련 정책적 모순점을 지적한 인물은?	민주당 박주선 최고위원	[WHO]
동양극장 사업을 실패로 돌아가게 만든 인물은?	최독견	[WHO]
본래, 한왕 측에서 팽성 대전에 참전했으나 한을 배신하고 항우의 편으로 넘어간 인물은?	위표	[WHO]
성화 점화 전에 비둘기를 풀던 방식은 어떤 올림픽 이후로 바뀌게 되었는가?	서울올림픽	[WHAT]
S.롱스타드 중위의 국적은?	노르웨이	[WHAT]
사람들은 간결과 진중권의 토론에서 누가 이겼다고 생각하는가?	진중권	[WHO]
독일이 여객선이 운항하는 해로에서 공격하지 않겠다는 의사를 밝히기 전 마지막으로 침몰한 배는?	여객선 RMS 루시타니아	[WHAT]
세키가하라 전투에서 요도도노의 라이벌은?	동군	[QUANTITY]
구글의 실시간 웹 서치 기능은?	구글 서치 서비스	[WHAT]
풍진의 전파 경로는?	기침	[WHAT]
분에이 전쟁 이후 로쿠하라 단다이에게 주어진 권한으로 처벌할 수 있는 신분은?	고케닌	[WHO]
과도위가 유엔의 승인 없이 외국군의 파병지원을 요청할 수 있게 된 날은?	2011년 7월 15일	[WHEN]
비메이로 전투에서 영국군 원정대가 프랑스 부대를 격파시킨 해는?	1808년	[WHEN]
공자 돌이 임금의 자리에 올랐던 시기는 언제인가?	기해일	[WHEN]
이스라엘이 수에즈 운하를 자유로이 왕래하는 조건으로 이집트에 반환한 지역은?	시나이 반도	[WHERE]
예루살렘 공의회는 누가 유대 그리스토교인의 주장에 반론하면서 개최되었나요?	이방 그리스도 교인	[WHO]
생물측정학파와 멘델학파의 대립을 해결한 신다원주의의 이론은?	근대적 종합	[WHAT]
아이들의 우울감은 어디서 오는가?	이전 가족의 해체	[WHERE]
대한민국 정부가 수립된 다음 해에 지어진 관청 건물은?	안양읍사무소	[WHAT]
오스트리아 황제가 항복했던 해에 나폴레옹이 패배했던 나라는?	영국	[WHERE]
조혜련은 기미가요 무대에 박수를 보낸 행동에 대한 해명을 어느 프로그램에서 하였나?	《황금어장 무릎팍도사》	[CITE]
세종대학교의 산하부서중, 한국형 온실가스배출 경로분석 프로그램을 개발한 곳은?	세종대학교 기후변화센터	[WHERE]
동영상 콘텐츠로 날씨를 제공하는 예보 유형은?	단기 예보	[WHAT]
나플레옹이 넬슨 제독에 의해 패배하게 된 전쟁은 언제 발발하였나요?	1803년 5월	[WHEN]
우리나라에서 유일하게 백로의 서식지가 아닌 곳은?	백두산 지역	[WHERE]
인정식이 일제 경찰에 체포된 해는?	1929년	[WHEN]
사자의 서신을 본 후 고구려 군사로 하여금 압록강 나루에 진을 치도록 만든 고구려의 장수는?	고구려 총사령관 대막리지 연남건	[WHAT]
인목의 굵은 가지와 원줄기에 생기는 형상과 비슷한 것은?	뱀가죽의 비늘	[WHAT]
도시조의 설득으로 결국 곤도가 얻고자 결정한 직위는?	다이묘(영주)	[WHO]
요자의 삼촌은 어떤 관직에 있었나?	환관	[WHAT]
한사람에게 같은 인슐린 주사를 처방했을 때 다르게 생성되는 것은?	피부 지방	[WHAT]
웨인을 사망에 이르게 한 합병증의 원인이 된 병은?	통풍	[WHY]
이혼성이 이유를 말하지 않았던 사건은 언제 일어났나요?	1931년	[WHY]
사천왕을 모시기 위해 조선시대부터 사찰입구에 건축한 건물은?	사천왕문	[WHAT]
의회와 정부의 갈등 때문에 군대를 동원한 사람은?	보리스 옐친 대통령	[WHO]
아르눌프가 교황 포르모소의 구원 요청을 수락한 년도는 언제인가?	893년	[WHEN]
원희룡이 사상적 전환을 맞게 된 계기가 된 것은?	동구권의 몰락	[WHY]
아라키스의 통치권을 원하는 가문이 황제에게 주어야 하는 것은?	스파이스 멜란지	[WHAT]
이탈리아 발말렌코에서 진행된 세계 주니어 선수권 대회에서 1등을 거머쥔 선수는?	미국의 브래들리 윌슨	[WHO]
마르첼로 1세가 시행한 내용을 알 수 있게 해주는 서적은?	《교황 연대표》	[CITE]
사물인터넷 보안 시스템 중 모은 정보를 서버로 보내는 역할을 하는 보안 시스템의 이름은?	IoT 게이트웨이 보안	[WHAT]
공박에 새롭게 추가된 인물은?	레이나	[WHO]
훈다손의 뜻은?	"""개의 새끼"""	[CITE]
소비에트 러시아 대표가 회의에 갈 수 없도록 만들었던 전쟁은?	러시아 내전	[WHAT]
1575년 아시가루가 다네가시마로 무장하고 참가한 전투는?	나가시노 전투	[WHAT]
하이네만이 두 번째로 법무장관에 취임한 것은 몇 년인가?	1966	[WHEN]
참의원 선거에서 신체 장애인 후보자로 당선된 최초의 인물은?	야시로 에이타	[WHO]
경쟁 조직 간의 폭력 행위가 잠시동안 잠잠해진 시기는 언제인가요?	1990년대	[WHEN]
후타마타구치 전투가 일어났던 달은?	4	[WHEN]
"""장씨종친회""가 실렸던 신문은?"	서울일일신문	[WHAT]
팔로마 로레나의 아들이 가장 처음 만든 영화는?	《메트로》	[CITE]
이주노동자를 위한 병원을 기점으로, 세계 곳곳에 의료지원이나 의료진 교육 사업을 진행하는 회사는?	라파엘인터내셔널	[WHAT]
등무칠이 반란을 일으키기 전에 없앤 것은 무엇인가요?	동생(冬牲)	[WHAT]
어떠한 목적 의식도 가지지 않은 상태를 장자는 뭐라고 했는가?	'소요유'	[CITE]
생활이 제일'이라는 구호를 내건 정당은?	민주당	[WHAT]
두 포르투갈어 화자가 처음 대화를 할 시에 곤란을 겪는 화자는?	브라질 포르투갈어	[WHO]
봉은사 승려를 문정왕후에게 주선해준 인물은?	정난정	[WHO]
《일본이란 어떤 나라인가》가 집필된 년도는?	1928년	[WHEN]
활동자격을 빼앗긴 당은 어떤 정치적 성향을 띠는가?	공산주의	[WHAT]
하장청이 마크의 삼촌을 죽인 수단은?	폭탄	[WHAT]
당중앙과 함께 공산당의 투쟁 방침을 논의하는 집단은?	정치국	[WHAT]
위표가 항우 쪽으로 돌아서는 계기가 된 발언을 한 인물은 누구인가?	허부	[WHO]
뉴크로부존의 마법 사용자들의 이명은?	마법사(thaumaturge)	[WHAT]
현판에 임영관이란 글씨를 자필로 쓴 사람은 누구인가?	공민왕	[WHO]
1561년, 안상에게 합자보를 수정하라고 지시받은 인물은?	악사 홍선종	[WHO]
선거에서 대통령 다음으로 표를 많이 받은 사람은 어떤 직책을 맡게 되는가?	부통령	[WHAT]
누르가치가 오바를 돕기 위해 파병한 것은 몇 년인가?	1625년	[WHEN]
남명혁 부인의 사망 당시 나이는?	36세	[QUANTITY]
아카리가 미조로기 료타를 만난 해는?	1974년	[WHEN]
장성향교는 임진왜란으로 소실 된 이 후 언제 다시 지어졌는가?	선조 33년(1600)	[WHEN]
남자와 딸들이 찾은 여자 시체는 몇 개인가?	1구	[QUANTITY]
모개가 관리 선발 시 가장 중시했던 것은?	청정과 절검	[WHAT]
프랑스에서 불법 다운로드를 한 사용자를 차단하는 법률을 제정한 곳은 어디인가?	헌법위원회	[WHERE]
일본이 영국과의 런던 군축조약에서 파기한 해는 언제인가?	1936	[WHEN]
조혜련은 <힐링캠프, 기쁘지 아니한가> 이전에 어떤 프로그램에 출연하여 일본 활동에 대해 언급하였나?	《황금어장 무릎팍도사》	[CITE]
스티븐 비건의 문재인 접견 당시 미국 행정수반을 맡았던 인물은 누구인가?	도널드 트럼프	[WHO]
아우구스투스의 군사 체제 이후 로마군대의 속칭은?	'북부 게르마니아 군단'	[CITE]
파르나바즈의 무덤 앞 석상은 무엇으로 제작되었는가?	산비탈의 석구조	[WHAT]
스퀠쾨더가 남군 해군에 인도된 시기는?	1865년 1월 7일이후	[WHEN]
박진이 기자로 있었던 곳은?	《별건곤》	[WHERE]
베네치아와 오스만 튀르크의 분쟁이 끝이 났음을 증명하는 것은?	콘스탄티노플 조약	[WHAT]
히로인이 좋아하는 마음으로 오빠를 부르는 호칭은?	'오라버니'	[CITE]
고천문학자는 연구할 때 사회 분야와 어떤 분야의 조화를 이루는 것이 중요한가?	과학	[WHAT]
큰 앞바퀴와 작은 뒷바퀴를 가진 자전거는 무엇인가?	페니파싱	[WHAT]
에마 가문의 멸망은 요리쓰나가 누구와 힘을 합쳐 이루어냈는가?	엣추의 삿사 나리마사	[WHO]
토지의 중요성에 대해 말한 인물이 한글을 알리기 위해 제작한 것은?	『신생명』	[CITE]
사후세계의 존재를 믿는 민족은?	잉카인	[WHAT]
카를로만과 파핀이 권력을 얻기 전에 가장 큰 권력을 가지고 있던 인물은?	카를 마르텔	[WHO]
개인이 기업의 자산을 보유하며 8명 이상의 노동자를 고용하여 수익을 얻는 기업의 유형은?	사영기업	[WHAT]
15세기 유럽에서 개발된 다표식 환자는?	비즈네르 암호	[WHO]
파울은 박스의 무엇을 먹는 방식으로 경기에서 누가 이길지 예측했나?	홍합	[WHO]
알라마간 섬을 통과할 때 태풍 초이완이 일으킨 바람의 세기는 어느정도였나?	230 km/h	[QUANTITY]
2004년 태화들 회의록 관련 소송에서 패한 것은?	울산시	[WHAT]
지라치를 납치한 사람의 직업은?	서커스 단장	[WHO]
조선시대에는 상민보다 누구의 도폭이 더 넓었나요?	양반	[WHO]
레이에게 킹 목사를 죽였는지에 관한 질문을 던진 사람은 누구인가?	킹 목사의 아들	[WHO]
<강희왕조>의 원작의 저자는?	얼웨허(이월하, 二月河)	[WHO]
원종 종무원이 이전하기 전 위치는?	동대문 바깥	[WHERE]
자영은 누구에게 옥새를 넘기며 항복했나?	유방	[WHO]
대한독립군단은 몇 년도에 설립되었나?	1920년	[WHEN]
번데기가 완전히 다른 모습이 되는 것을 무엇이라고 부르는가?	완전 변태	[WHAT]
탄산염과 규산염질로 이루어진 퇴적물은 어디에서 온 것인가?	해양	[WHERE]
홈즈는 무엇을 통해 본인의 추리가 잘못되었다는 것을 알게 되었나?	남편이 직접 쓴 편지	[WHAT]
대부분의 입시가 사용하는 선발 기준은?	상대적 기준	[WHAT]
에린이 열대폭풍으로 지정된후 바로 대류가 약해졌다고 분석된 이유는?	건조한 공기가 순환에 깊이 침투했기 때문	[WHY]
크로아티아 국가방위군이 형성된 해는 언제인가요?	1991년	[WHEN]
다윈에 의하면 진화과정에서 가장 중요한 결정 주체는?	자연	[WHAT]
잉카제국의 마지막 왕은 ?	투팍 아마루	[WHAT]
프리마 카테고리아 1912-1913 결승전에서 6-0으로 패배한 팀은?	라치오	[WHAT]
크라이자우어 크라이스가 가담한 것은?	'반나치주의'	[CITE]
이집트를 통일한 나라가 섬긴 신은?	호루스	[WHAT]
알파급 잠수함들이 신뢰성을 높이기 위해 원자로를 무엇으로 대체했나?	경수로	[WHAT]
크릭이 케임브리지에 있었던 기간은?	30년	[WHEN]
요리노부는 어떤 사건을 계기로 무가동량이 되었나?	추토의 성공	[WHY]
베네딕토 16세가 삼층관을 없앤 뒤 그려 넣은 것은 무엇인가?	세 줄의 금색 띠	[WHAT]
지출 대비 저수입을 강요 당하는 것은 공익사업의 어떤 특성 때문인가?	공익성	[WHAT]
바다의 왕관을 빼앗으러 아크셔를 습격한 인물은?	팬텀 톨프	[WHO]
《마라의 죽음》은 무슨 목적으로 만들었나?	매력적인 영웅을 추모	[WHAT]
한국전쟁은 남한이 일으켰다고 주장한 사람은?	말리크	[WHO]
율레스 레폰트가 디자인하기 직전 제복은 어디에서 볼 수 있는가?	‘교황 식스토 3세와 대화를 나누는 에우독시아 황후’	[WHERE]
카자흐스탄에서 즐겨먹는 소시지의 주재료는 무엇인가요?	말고기	[WHAT]
대한민국 대 알제리에서 후반전 시작 후 5분만에 골을 넣은 선수는?	손흥민	[WHO]
어떤 호칭이 공의회의 승인을 받았나?	하느님의 어머니	[WHAT]
베트남 내전이면서 국제전의 모습이었던 전쟁은 언제 끝났는가?	1975년	[WHEN]
중공군에게 잡히지 않은 스코틀랜드군 대부분이 살아남은 곳은 터널과 어디인가?	참호	[WHERE]
500만원의 벌금형에 처해졌던 사건은 언제 일어났나요?	2011년~2013년	[WHEN]
작품에서 로즈의 남자친구 역할을 맡은 배우는?	노엘 클라크	[WHO]
사용대차에서 일방이 상대방에게 목적물을 제공하는 대가는?	무상	[WHAT]
이강주처럼 공격수에서 리베로로 전향하여 최고가 되었던 인물은?	여오현	[WHO]
온타리오 요새가 만들어진 연도는?	1755년	[WHEN]
192년에 곽사와 일대일로 교전을 벌인 인물은?	여포	[WHO]
선형대수학을 활용하면 어려운 비선형 방정식 문제를 무엇으로 바꿀 수 있는가?	간단한 선형 방정식 문제	[WHAT]
MRI는 토르플렉시스 검사와 관련해 어떤 부분에서 도움을 주는가?	진단에 대한 기본 식이학을 결정하는 데	[WHAT]
우라노스가 가이아의 자식들을 가둔 곳은?	저승 타르타로스	[WHERE]
궁펑과 결혼하던 시기, 차오관화의 소속 정당은?	중국공산당	[WHAT]
라구엘이 교회들을 화해시키도록 지시한 인물은 누구인가요?	하느님	[WHO]
신뢰할 수 없는 데이터를 받는다면 무엇에 문제를 일으킬 수 있는가?	보안	[WHAT]
프란체스코 페레이라 코티뉴가 항해한 배는 몇 년도에 출발했나요?	1515년	[WHEN]
정형 삼차신경통에 도움이 되지 않는 약물은?	오피오이드	[WHAT]
주체는 현상에 의해 이뤄지지 않고 존재로서 인식하지 못한다는걸 칸트는 무엇이라고 여겼는가?	물자체	[WHAT]
당간지주를 볼 수 있는 시설은?	절	[WHAT]
거제시에서 만세운동을 기념하는 행사가 5월 2일에 열렸던 이유는?	과거 음력에 맞춰 작성한 것으로 오해를 받은 탓	[WHY]
한복이 등장하지 않는 부는?	제3부	[QUANTITY]
필수 자격으로 이슬람 신학교 졸업과 군에서 실시하는 시험 합격이 요구되는 것은?	군종 이맘	[WHAT]
워싱턴과 관계있는 전시품을 볼 수 있는 곳은?	도널드 W. 레이놀즈 박물관 교육 센터	[WHERE]
가도를 이용한 여행의 증가에 영향을 준 나라는?	러시아	[WHERE]
카프 구단을 첫 A클래스로 이끈 감독의 이름은?	고모리 미쓰오	[WHO]
색슨족이 사용하던 언어는?	저지 게르만어	[WHAT]
도브로 폴 전투에서 불가리아군이 패배한 해는?	1918년	[WHEN]
마티디아를 위해 신전을 세운 사람은 누구인가?	로마 황제 하드리아누스	[WHO]
어른임을 증명해서 상좌를 차지하는 잔치를 연 동물은?	노루	[WHAT]
가울리가의 공식 시합이 종료된 날짜는?	4월 23일	[WHEN]
메이지 정부의 개혁에 이의를 제기하는 가문을 뭐라고 지칭했는가?	‘불평사족’	[CITE]
왕위 계승 전쟁에서 이긴 사람은 누구인가?	이사벨 1세	[WHO]
산업기술연수제도는 어느 나라의 제도를 바탕으로 만들어졌나요?	일본	[WHERE]
니더슐레지엔 대관구의 유일한 지휘자는?	카를 항케	[WHO]
한국이 MDAP 예산을 원조 받으려면 반드시 거쳐야 하는 절차는?	하원의 동의	[WHAT]
로제스트벤스키는 음악 감독으로서 몇 년동안 일했나?	13년간	[WHEN]
드래곤이 나쁜것을 상징한다고 주장한 분파는?	기독교	[WHAT]
베토벤을 감시했을 것으로 보이는 정부는?	메테르니히 정권	[WHAT]
미에빌이 2001년 선거에 출마해 얻은 득표 비율은?	1.2%	[QUANTITY]
중종이 죽은 후 왕위에 오른 인물이 거주하던 곳은?	강녕전	[WHERE]
확증 편향을 소재로 한 작품의 제목은?	《라쇼몽》	[CITE]
오선화가 귀국에 대한 증명을 요청한 기관은 어디인가요?	제주총영사관	[WHERE]
브라질 언론사가 연도와 국기를 가지고 조롱한 선수는?	독일의 미드필더 토니 크로스	[WHO]
보통 국무대신이 국회의원을 같이 맡는 정치 시스템은?	의원내각제	[WHAT]
카를로 피코르니에가 베버르베이크 근처 운동장에서 부상을 당한 일은 무엇이라 불리는가?	"""베버르베이크의 전투"""	[CITE]
신시가지는 누가 조성하였나요?	유럽인	[WHO]
신돈이 권력가 자식의 빠른 출세를 막기 위해 실행한 것은?	순자격식	[WHAT]
바버, 리게티, 스트라빈스키 등이 피아노 협주곡을 작곡한 시기는?	20세기 이후	[WHEN]
중동지역에서 유일하게 성공한 경제 자유구역은?	두바이	[WHAT]
이브라임 퍄샤는 누구의 자식인가?	메메트 알리	[WHO]
《도구적 이성 비판》에서 '객관적 이성'의 상대 개념은 무엇인가?	‘주관적 이성’	[CITE]
2018년에 김정은을 중화인민공화국에 초대한 사람은?	시진핑	[WHO]
무씨가 죽은 이후 허망해하는 이융기에게 고력사가 권유한 장소는 어디인가?	화청지(華淸池)	[WHERE]
반대당과 협의하여 제임스 2세를 폐위시킨 정당은?	토리당	[WHAT]
니켈은 어떤 과정을 통하여 추출이 가능한가요?	복잡한 이온이 포함된 수증기적 공정	[WHAT]
모닝스타를 사용하기 시작한 시기는?	14세기	[WHEN]
과거 기록물에서 알 수 있는 지진의 강도는?	6.5 이상	[QUANTITY]
밀풍군 탄의 아들이 김씨의 양자가 된 해는?	1727	[WHEN]
금붕어의 경우에 신장을 다치면 무엇이 재생되나요?	네프론 전체	[WHAT]
한나 아렌트가 악의 평범성에 대해 이야기한 저서는?	《예루살렘의 아이히만》	[CITE]
노퍽 카운티에서 탈출한 노예 3명을 지켜준 지휘관의 이름은?	벤자민 버틀러	[WHO]
봉기군과 함께 영국군의 협상가를 살인한 경찰의 소속 지역은?	페다인	[WHERE]
케트 막 마가트의 라이벌은?	울라의 코날 케르나크	[WHAT]
긴 시간동안 진화가 이루어지지 않은 동물은?	생쥐	[WHAT]
인간 몸의 본질적 특성이 확립되기 시작한 시기는?	18세기	[WHEN]
마흐무드 알카슈가리가 <튀르크어 대사전>을 만들기 시작한 년도는?	1072	[WHEN]
아르군 칸이 호노리오 4세에게 보낸 친서의 번역본이 보괸되어 있는 곳은?	바티칸	[WHERE]
"양자 컴퓨터에서 ""모든 예제의 정답을 맞출 가능성이 높다""의 의미를 가진 말은?"	"""푼다"""	[CITE]
우부승지와 함께 윤원형과 이기를 비판하고 내쫓는데 가담한 인물의 직책은?	대사헌	[WHO]
체임벌린의 국내 정책 중, 인구의 의료 조사를 위해 만든 것은?	신체 훈련 법령	[WHAT]
타끼야는 이슬람의 어느 종파에게 강력한 지지를 받는가?	시아파	[WHAT]
사망할 때까지 보릴과 동맹 관계를 유지한 사람은?	스트레즈	[WHO]
최초의 총장은 몇 년도까지 임기를 유지했는가?	1119년	[WHEN]
플레이어가 수직적인 전투를 펼쳐야 하는 지형은?	절벽	[WHAT]
사산성에 대한 설명이 남아 있는 기록은 무엇인가?	《동국여지승람》	[CITE]
동체부에 있는 용을 그릴때 무엇을 사용하였는가?	철사안료	[WHAT]
마리아의 큰오빠는 어느 나라에서 태어났나요?	독일	[WHERE]
에이든이 다룰 수 있는 물체는 보통 어떠한 색을 하고 있는가?	파란색	[WHAT]
물질파 가설을 바탕으로 발표된 방정식은?	슈뢰딩거 방정식	[WHAT]
아후가니스탄은 무슨 장르인가?	역사 코미디물	[WHAT]
훼손 시에 대비할 수 있는 장비나 설비가 완벽하지 않아 패배하게 된 전투는?	미드웨이 해전	[WHAT]
데카브리스트 중 처형되고 감옥에 간 사람들을 제외한 나머지는 어디로 귀양 가게 되었나?	시베리아	[WHERE]
관측천문학 부문에서 별의 광도 계측에 사용되는 것은?	사진	[WHAT]
니샤푸르를 다스리기로 한 군주는?	투으룰	[WHO]
매사추세츠 공과대학교에 있는 PDP-1을 제공한 회사는?	DEC사	[WHAT]
임오군란이 일어났을 때 명성황후가 도피한 곳은?	장호원	[WHERE]
샤이반계 유목민들이 주치 울루스의 소유권을 두고 분쟁한 상대는?	티무르 왕조	[WHO]
떠돌이 빈곤층이 모이는 형태의 도시문제가 발생하는 곳은?	저개발국	[WHERE]
스가 요시히데가 브리핑을 진행했던 년도는?	2016년	[WHEN]
보니파시오 5세의 선대 교황은 누구였나?	교황 아데오다토 1세	[WHO]
지크 예거가 키요미에게 넘기려 한 인물은 어디에 거주하고 있었나요?	파라디 섬	[WHERE]
2차 대륙회의는 언제 열렸나?	1775년 5월	[WHEN]
불타는 수도원에서 형제들이 찾아냈지만 그 이후 볼 수 없었던 것은?	성물	[WHAT]
CIS 탄생의 계기가 된 인물은 누구인가?	옐친	[WHO]
보다스가 교장으로 재임하고 있는 곳은 어디인가?	케랄라 주의 파일럿 양성 학교	[WHERE]
서울 지역 대학교 총학생회에 도움을 준 회사는?	'세인출판사'	[CITE]
1919년 비트겐슈타인의 원고를 대신 출판한 사람은?	러셀	[WHO]
어셈블리의 구성 요소 중 어셈블리에 대한 고유값을 가진 것은?	공개 키 암호 방식(public key) 토큰	[WHAT]
2005년에 <선군화원에 꽃들은 만발한다>라는 글이 실린 언론은?	《로동신문》	[CITE]
인천 아시안 게임에서 북한의 인공기는 누구의 반대로 없어졌나요?	보수단체	[WHO]
검은담비가 주로 먹는 식물은 무엇인가?	히말라야삼목의 솔방울	[WHAT]
후루오야 마사토에게 남우주연상을 두번이나 안겨준 작품은?	《히포크라테스들》	[CITE]
스빈후부드가 신분제 중심의 핀란드 국회를 개혁하는데 큰 영향을 미쳤던 시기는?	1905년	[WHEN]
자본주의적 성향을 띠는 농업 구조는 무엇에서부터 발전됐는가?	봉건적 농업 구조	[WHAT]
궁정 유대인의 사업 대상은?	기독교인 귀족	[WHO]
Lee Ross의 실험 중 활용된 에세이에서 입장 차이의 기준이 된 인물은?	카스트로	[WHO]
주종찬이 그의 손에서 나오는 피로 쓴 글자는?	‘일심(一心)’	[CITE]
김 루치아의 재판 결과 내려진 선고는?	사형	[WHAT]
손님이 집에서 신발을 벗는 경우가 거의 없는 나라는?	아일랜드	[WHERE]
니시노미야 구장에서 삼진 신기록이 나왔을 당시 아웃당한 주자는 누구인가?	가토 히데지	[WHO]
주요 그리스 국가 중 필리포스에게 항복하지 않은 국가는?	스파르타	[WHERE]
미국 전 지역과 영연방에서 인기가 많았던 구두약은?	키위 구두약	[WHAT]
진우량이 도피처로 결정한 곳은 어디인가?	무창	[WHERE]
죽림사 세존괘불탱은 어떤 재료 위에 그려졌는가?	비단	[WHAT]
발전소의 연료로 이용되며 선박의 추진에 영향을 미치는 것은 무엇에 의해 만들어지나요?	Boil-Off 효과	[WHAT]
구슬 모양이 특징인 불상의 머리부분은 무엇을 본떠 만든것인가?	연꽃잎	[WHAT]
코로나 시기에 전랑 외교는 어떤 단어로 쓰이기 시작했나요?	유행어	[WHAT]
아우구스투스에게서 황제의 징표를 빼앗은 사람은 어느 민족인가?	게르만 족	[WHAT]
개 홍역 바이러스가 그늘진 곳보다 더 오래 생존 가능한 곳은?	혈청이나 조직물에서	[WHERE]
자캐오가 회개의 결단을 표현한 말은?	"""소유의 절반을 가난한 자들에게 주겠으며, 만일 누구의 것을 부당하게 취한 일이 있으며 사 배나 보상할 것"""	[CITE]
기원전 379년 테베의 시민궐기를 이끈 단체는?	펠로피다스 일파	[WHAT]
윤치호가 국방군 양성을 위해 만들자고 건의한 것은?	사관학교	[WHAT]
모스크바 아나키스트 그룹 연맹의 주요 활동 대상은?	모스크바 빈곤층	[WHO]
컴퓨터가 실험실에서 보편적으로 이용되기 시작한 시기는?	1990년대	[WHEN]
이집트의 통치자가 되기 위해 호루스가 대적한 것은 누구인가?	세트	[WHO]
김학규가 김준연과 한민당을 싫어하게 된 계기는?	자신들을 공산당으로 몰고 간 일	[WHY]
오윤부의 이름 앞에 붙었던 칭호는?	일관	[WHAT]
켈시 그래머가 엑스맨: 최후의 전쟁에서 비스트역을 연기한 후에 다시 그 역으로 출연한 작품은?	엑스맨: 데이즈 오브 퓨처 패스트	[WHAT]
유성 생식을 하지 않는 생물의 종류는?	단세포 생물	[WHAT]
불가살이가 먹은 무기들을 사용하는 장수는 실제로 어느 나라 사람인가?	일본	[WHO]
로봇을 제어하기 위해 설치해야 하는 것은?	전용 앱	[WHAT]
엘리너 여사는 트루면 대통령으로부터 어떤 직무를 위임 받았는가?	유엔 총회의 사절단	[WHAT]
1859년 2월에 코친차이나의 사이공에 원정간 인물은?	리고 드 주누이	[WHO]
진성이 좋아하던 물건 중 장모가 싫어했던 것은?	고급 하이파이 오디오	[WHAT]
1996년의 설 특집 드라마는 어떤 축제에서 특별상을 받았나요?	뉴욕 페스티벌	[WHAT]
제시카 런스포드 법'이 만들어진 것은 언제인가?	2005년	[WHEN]
정부의 인프라 구축으로 인해 충남대와 더불어 인터넷 관련 혜택을 본 학교는?	카이스트	[WHERE]
가성 소다 공장의 리빌딩이 완료된 것은 언제인가?	2003년	[WHEN]
다린 켄드릭이 구속된 곳은 어디인가?	포드 에코놀린 승합차	[WHERE]
일제강점기 당시 청소년 미술 교육을 진행한 곳은?	고려미술원	[WHERE]
윌리엄 3세가 2개 지역의 왕이었던 해는?	1701년	[WHEN]
손지환이 부회장 역할을 맡았던 조직에서 설치하여 운영한 것은?	집단농장	[WHAT]
강화 샤이닝 라이더 킥에서의 에너지는 어떤 모양을 착안하여 만들어졌는가?	6개의 뿔	[WHAT]
루카스 바첸로데 다음으로 대주교가 된 사람은?	파비안 루찬스키	[WHO]
후안 마요르가는 <다윈의 거북이>로 어떠한 결과를 얻었나?	막스(Max) 상	[WHAT]
2가지의 공국으로 나눠지게 된 곳은 어디인가요?	브르타뉴 지역	[WHERE]
사회주의가 자유민주주의처럼 보호받아야한다고 장면이 주장했던 곳은?	신문 주간 연설	[WHERE]
계속되는 러시아의 세력 확장에 강희제가 지은 건물은?	애혼성(愛琿城, 아이훈 성)	[WHAT]
도자와시가 참석한 회의의 결과는 언제 발표되었나요?	12월 4일	[WHEN]
아이제나흐파(派)의 중요인물은 누구인가요?	아우구스트 페르디난트 베벨	[WHO]
펠리페는 어떤 나라를 대표하여 바르셀로나 올림픽에 참가하였는가?	스페인	[WHAT]
영국 해군이 다시 후장포를 사용하기로 한 것은 몇 년도인가?	1879년	[WHEN]
제파 디 미노는 친구의 아내에게 함께 복수하기를 부탁하며 무엇을 건네었나?	보석	[WHAT]
당나라군의 몰락에 결정적인 역할을 한 세력은 누구인가?	카를룩족	[WHO]
일본 역사상 처음으로 패배한 무사가 할복하지 않게 도와준 사람은?	도쿠가와 이에야스	[WHO]
존 릿지는 누구와 정치적인 힘겨루기를 하였나?	체로키 족이 선택한 존 로스 수장	[WHO]
쿠 훌린의 아들이 콘늘라임을 알고 쿠 훌린에게 알리려 한 사람은?	에버르	[WHO]
호키가와 강 하부와 연결되어있는 강은?	나카 강	[WHAT]
게오르크의 음악에 대한 천재성은 언제부터 사람들에게 보여졌나요?	11세	[WHEN]
마르크수 주의를 주장하는 사람들이 자본국가를 어떻게 지칭하는가?	“부르주아 독재(Dictatorship of the bourgeoisie)”	[HOW]
전기배선용에는 무엇에 의한 손상을 막기 위해 온도조정기능이 있나요?	열	[QUANTITY]
윤치호가 미국을 더이상 정의와 자유의 국가라 여기지 않게 된 것은 어떤 조약 때문인가?	가쓰라-태프트 밀약	[WHAT]
데네볼라가 에너지 생산을 위해 연소시키는 물질은 무엇인가?	수소	[WHAT]
신한청년당이 파리강화회의에 특파한 인물은 누구인가?	김규식	[WHO]
오영제의 직업은 무엇인가?	치과의	[WHAT]
선교사들과 함께 잠자리와 음식을 제공받은 인물은 누구인가?	앵베르 주교	[WHO]
동관이 요나라를 침략하기 위해 동맹을 맺은 나라는?	여진	[WHERE]
그림 형제가 처음 엮어낸 책은?	《어린이와 가정을 위한 이야기》	[CITE]
상품화폐의 인플레이션을 제재하지 못하도록 하는 것은?	중앙은행업	[WHAT]
터널 내의 환기 방식은 횡류식에서 어떤 방식으로 바뀌었나요?	제트팬이 설치된 종류식	[HOW]
해왕성의 불규칙 위성 중 해왕성과 가장 멀리 떨어진 것은?	네소	[WHAT]
고려 고종 때 유일하게 구제약으로 쓰였던 것은 무엇인가요?	비자나무 열매	[WHAT]
현생 양서류의 호흡방식을 이용해 몸 밖으로 내보낼 수 있는 것은?	이산화탄소	[WHAT]
키루스가 형을 몰래 죽이려 했던 계획을 사전에 고발했던 인물은?	티사페르네스	[WHO]
철불상이 많이 제작된 시대는 언제인가?	통일신라 후기	[WHEN]
마블고양이가 다른 고양이들에 비해 더 긴 것은 무엇인가요?	꼬리	[WHAT]
일리아드 첫 장면에 나오는 것은 누구인가?	크리세스	[WHO]
목섬의 동백나무는 어디서 유래됐다고 하는가?	울릉도	[WHERE]
철갑기병이 주로 사용하던 무기는?	긴 창	[WHAT]
적진의 측면을 먼저 무너뜨리고 그 우위로 적의 중앙을 공격하는 전략은?	망치와 모루 전술	[WHAT]
카르타고군이 전투에 사용한 동물은?	코끼리	[WHAT]
보티건은 누구의 조언을 듣고 탑을 건설하려 했나요?	마술사들	[WHO]
장민호를 다른 연예인과 비유해 설명한 인물은?	영기	[WHO]
니어브가 핀 막 쿠월을 만나러 갈 때 이용한 수단은?	마법적인 암말 엔바르	[WHAT]
이자성이 산해군을 공격할 때 동원한 군사의 수는?	6만 명	[QUANTITY]
타지마할은 누구의 무덤인가요?	아내 뭄타즈 마할	[WHO]
키토 지역 토착민들이 잉카 군대에게 큰 타격을 준 곳은?	에콰도르 북부 지역	[WHERE]
백제가 2가지 언어를 사용하는 나라였을 수 있다고 주장한 사람은?	언어학자 이기문	[WHO]
지오영과 유통마진을 나누어 갖는 기업이 공급하는 마스크 비율은?	70%	[QUANTITY]
스카를라티가 처음 나폴리에 거주한 것은 몇 년인가?	1685년	[WHEN]
루키우스가 율리우스 법을 통과시킨 시기는?	기원전 90년	[WHEN]
나이가 아닌 신분을 기준으로 할인이 적용되는 곳은?	청주시	[WHERE]
시민주의적 성향을 보인 정기 간행물은 무엇인가?	〈새로운 자유 언론〉	[CITE]
용화사 내부의 오른쪽에 있는 작은 바위에서 누가 자주 기도하나?	임신하지 못하는 많은 사람들	[WHO]
벨기에는 어느 전쟁에서 패배하여 독일군에 의해 요새를 잃게 되었나요?	리에주 전투	[WHAT]
브르너는 카롤루스 마르텔루스가 교회 토지를 빼앗아 어떤 군인을 키우려 했다고 주장했나?	기병	[WHAT]
젊어서부터 군대에서 두각을 나타낸 사람은?	발렌티니아누스 1세	[WHO]
스밀레츠는 어느 나라의 간섭에 의해 황제가 되었는가?	몽골	[WHERE]
오자와가 핼시를 꾀어내기 위해 손실을 감수한 것은?	항공모함	[WHAT]
네덜란드 국가대표팀에서 가장 많은 골을 넣은 선수는?	파트리크 클라위버르트	[WHO]
후고의 추대에 도움을 줬다는 의심을 사 바벤베르크에게 공격받은 사람은?	고드프리드	[WHO]
오스만 제국의 황제가 누구한테 권위를 행사하기 위해 칼리파권을 양위받았나?	오스만 제국 내외의 무슬림들에게 영향을 미치기 위해	[WHO]
레닌의 선봉대로 러시아 제국을 완벽히 무너뜨린 단체는?	볼셰비키	[WHAT]
위험중립 측도에서의 적정가격이 실제로 사용될 수 있게 하는 것은?	실제측도	[WHAT]
세균은 사람의 몸속에 들어올 때 어디로 들어오나?	혈관	[WHERE]
면역력이 약한 환자의 경우, 항생제 치료법 효과가 미미할 수 있는 원인은 무엇인가?	바이러스 감염	[WHY]
2014년 7월 14일 이후로 고속도로 노선을 지정하는 주체는?	국토교통부	[WHAT]
김조원이 청와대 민정수석이 되는 것을 반대한 사람은?	마린온 추락 사고 유가족들	[WHO]
루체왕국은 아시아지역의 몇 개의 거점이 연합해서 만들어졌나?	4개	[QUANTITY]
일본에서 지진 피해를 입지 않은 건물은 무엇인가?	일본흥업은행 본점	[WHAT]
조지아 식민지의 칙허장을 발급받은 자가 금지했던 제도는?	노예제	[WHAT]
플레이어가 이길 승산이 있는지 예측할 수 있는 문서는?	증서	[WHAT]
후두의 영어표현은 누구에게서 비롯된 것인가?	아담	[WHO]
황금 양을 가지면 왕이 되어야 한다는 티에스테스의 의견에 동의한 인물은?	아트레우스	[WHO]
보속은 어떤 종교에서 속죄 행위라는 의미로 쓰이나요?	기독교 신학	[WHAT]
그림 형제가 《소년의 마적》에 영향을 받아 출간한 서적은?	《어린이와 가정을 위한 이야기》	[CITE]
윈스턴 처칠 총리 이전의 보수당 총리는?	네빌 체임벌린	[WHO]
현재 사용되는 가타카나를 체계화한 법규가 발표된 해는?	1900년	[WHEN]
엘디아의 초대 황제라고 알려졌던 사람을 노예로 부리던 사람은 누구인가?	'프리츠'	[WHO]
이중로의 얼굴 그림에서 옷 테두리와 같은 색으로 그린 부분은?	윗 눈꺼풀 부위	[WHAT]
압둘라의 아버지를 죽게한 병 이름은?	비호지킨 림프종으로 관련된 합병증	[WHAT]
이보 안드리치가 시집 <알리야 제르젤레즈의 여행>을 발표한 해는 언제인가?	1920년	[WHEN]
《볼티모어 선》지에서 피닉스와 위더스푼을 호평한 사람은?	마이클 스래고	[WHO]
프티 부르주아적 급진주의'의 형성 가능성이 있는 계층은?	구중간층	[WHAT]
농업과 목춥업 등이 구축되는 근원이며, 생산력의 근간은?	토지	[WHAT]
액운공사에 대한 설명이 나와있는 저서는?	〈대순경전〉	[CITE]
1999년에서 2004년까지 비타민 A 보충으로 목숨을 건진 사람은 대략 몇 명인가?	2백만명	[QUANTITY]
미국 국내 노동 관계법의 별칭은?	와그너 법령	[WHAT]
오카야마 공습 전후로 국도 주변에 형성된 것은 무엇인가?	상점	[WHAT]
마르코스 정권이 공항에서 암살한 필리핀 야당 지도자는?	베니그노 아키노	[WHO]
클린턴은 1996년 재선에서 누구를 꺾고 선거를 이겼나요?	자신의 공화당 상대 후보 밥 돌	[WHO]
루카시의 아들이 태어난 곳은?	펜실베이니아주 오노라	[WHERE]
토리노 조약을 맺은 년도는?	1860년	[WHEN]
이광의 할아버지는 누구인가?	사도장헌세자	[WHO]
갈릴레이는 무엇을 이오와 동일한 천체로 생각했나요?	유로파	[WHAT]
1930년대 초중반에 전수린과 함께 작곡가로 쌍두마차를 이룬 사람은?	김교성	[WHO]
윤치호가 독립운동에의 참여를 등한시하기 시작한 해는?	1916년 4월	[WHEN]
다수의 태국 왕들이 승려로 임명되었던 절은 어디인가요?	와트 보원니웨트	[WHERE]
네브카드네자르 2세의 부인은?	왕비 '아미티스'	[WHO]
삼성이 더이상 한겨레를 광고하지 않는 까닭은?	한겨레가 삼성에 대해 악의적인 보도로 일관하고 있다고 판단	[WHAT]
고쿠데라의 머리 모양에 영향을 준 것으로 추정되는 사람은?	Dr.샤멀	[WHO]
카자크의 소통 언어는?	동슬라브어	[WHAT]
임선규의 작품이 처음으로 공연한 극장은?	동양극장	[WHAT]
1978년 콘클라베의 승자는?	알비노 루치아니	[WHO]
프로그램 관리자 역할을 시작 메뉴가 맡았던 최초 버전은?	윈도 95	[WHAT]
진승현이 각종 불법 행위를 통해 만든 것은?	비자금	[WHAT]
이사회에 가입되어있는 회원국 수는?	54개	[QUANTITY]
로그 혁명 사건의 주도 세력은?	세르브인	[WHAT]
오스만 튀르크의 영토가 축소된 원인은?	세브르 조약	[WHY]
찰스 도우슨에게 유골의 파편을 준 것은 누구라고 했나?	필즈 다운의 노동자	[WHO]
루움 전쟁에서 에이스 부대로 활약했던 집단은?	'검은 3연성'	[CITE]
유상이 사용한 약 중 스님과 관련된 약은 무엇인가?	감꼭지탕	[WHAT]
이규완은 무엇을 발전시켜야 사회의 발전과 문명화를 이룰 수 있다고 했나?	식산흥업	[WHAT]
트로이아 목마 반입에 반대한 예언자는?	카산드라	[WHO]
<우순소리>를 금지시킨 제도는?	내부고시 제27호	[WHAT]
진나라에 복종하려 했지만 대부들의 저항이 심했던 나라는?	허나라	[WHERE]
코치슈가 음악 감독을 그만둔 건 언제인가?	1997	[WHEN]
행복추구권의 줄이지 않은 원래 용어는?	"""행복 추구에 대한 국민의 권리"""	[CITE]
수고당에 보존되어 있는 의류는 누구의 것인가?	외재 이단하 내외분	[WHO]
사지 일가가 오노 성을 다스리기 이전에 군림하던 일가는 어디인가?	잇시키 가문	[WHERE]
북극의 얼음층에 서식하며, 북극곰의 주식이 되는 동물은?	물범	[WHAT]
신체에 령주를 새긴 마술사는 몇 명인가?	7명	[QUANTITY]
경찰들의 주장이 거짓이라는 증거가 된 물건은?	근처 식당의 감시 카메라	[WHAT]
베트남의 남북을 갈라지게 만든 군사 분계선이 위치한 곳은?	북위 17도	[WHERE]
황제 즉위 초반부터 농업 발전에 엄청난 공을 들인 인물은?	홍무제	[WHO]
시칠리아 지원군은 어느 세력을 돕기 위해 오는가?	몰타 기사단	[WHAT]
13살 때 아버지가 죽은 인물이 태어났던 해는?	1786년	[WHEN]
사건 관련자가 이홍기가 아니라 이종현임을 밝힌 언론사는?	SBS	[WHAT]
손일은 본인이 기습 공격 대상이 된 것을 알아챈 후 어디로 도망갔나?	위나라	[WHERE]
이란에서 쿠데타를 시도한 당이 만들어진 연도는?	1945년	[WHEN]
필리핀 1페소는 원화로 얼마 정도 하는가?	20원	[QUANTITY]
장씨의 항소심이 열린 곳은?	부산고등법원	[WHERE]
카리용 요새가 만들어지는데 요인을 제공한 나라는?	프랑스	[WHY]
류리크 왕조가 세워진 이후 카간이라는 명칭은 무엇으로 바뀌어갔나?	대공	[WHAT]
여운형이 직업을 가져야 한다는 아버지의 말에 따라 새로 입학한 교육기관의 명칭은?	우무학당(郵務學堂)	[WHAT]
빌럼 왕세자(훗날 빌럼2세)의 아버지가 살고있던 나라는?	네덜란드	[WHERE]
알루미늄 합금 차체는 어떤 부분에서 약점을 보이는가?	철분 등의 이종 금속 부착에 의한 산화(전해부식)	[WHAT]
정부가 강제로 이주시킨 대상은?	크리크족 인디언	[WHO]
라세레나의 별칭은 무엇인가?	"""교회들의 도시"""	[CITE]
기존의 성능보다 업그레이드 된 하이퍼카드를 구현하도록 만들어진 언어는?	하이퍼토크	[WHAT]
진국이 확실한 형태의 국가가 아니라고 해석했던 인물은?	미시나 쇼에이	[WHO]
Israels가 초반에 몰두하여 그린 그림의 종류는?	역사화	[WHAT]
문정왕후가 친형제들의 싸움에서 편을 들어주지 않은 인물은?	윤원로	[WHO]
책 《예언이 빗나갈 때》에서 컬트 집단이 주장한 멸망의 날은 언제인가?	1954년 12월 21일	[WHEN]
국방군 무오설에서 독일 국방군과 유사하다고 주장했던 군대는?	연합군	[WHAT]
AMBAC 성능이 저하된 증가장갑의 부위는?	기체 전면 장갑	[WHAT]
데니소바 동굴에서 발견된 화석은 인류의 어떤 종과 유사했나요?	네안데르탈인	[WHAT]
도미니카 공화국에 허리케인경보가 약 하루정도 유지되었을 당시 앨런이 위치했던 바다는?	카리브 해	[WHAT]
그리스 화가의 기록에 대한 도전이 나타나는 작품은?	《태풍》	[CITE]
대적광전 주변에 세워진 탑 중 기단이 한 층만 있는 탑은 무엇인가?	동탑	[WHAT]
처음 듀이가 헤드라인을 달성할때 기소한 인물이름은?	왝시 고든	[WHO]
멀티플레이 종류 중 녹스의 꽃의 구체적 명칭은?	'아레나'	[CITE]
치료 시작시기나 치료 전 발작 횟수가 결과를 미치는 것은?	약물 치료에 대한 반응	[WHAT]
숙종의 꿈 속에 나온 사람은 누구를 언급했나?	유 의원	[WHO]
서방 교회의 분열을 종결시킨 사람은?	신성 로마 제국의 황제 지기스문트	[WHO]
크세르크세스 1세의 두 번쨰 침공이 실패한 원인이 된 전투는?	〈플라타이아 전투〉	[WHY]
모브의 동생에게 초능력이 생기는 계기가 된 인물은?	카무로	[WHO]
브리튼이라는 이름이 처음으로 나타난 곳은 어디인가?	《잉글랜드 교회사》	[WHERE]
1974년에 FIFA 월드컵이 열린 나라는?	서독	[WHERE]
카스가는 복역 기간은?	18년	[WHEN]
초대 교회에서 성당 중앙에 놓았던 것은?	제단(祭壇)	[WHAT]
고갱의 표현주의적 특징을 표현주의 화가들이 발전시킨 시기는?	20세기	[WHEN]
아이오와 주는 미국 내 옥수수 재배량의 대략 얼마를 점유하는가?	5분의 1	[QUANTITY]
독립운동 중 감옥에 수감되었으며 고문의 후유증으로 사망한 인물은?	권사연	[WHO]
제임스 보이가 격리된 것은 무엇 때문인가?	결핵	[WHAT]
1954년 월드시리즈 우승 팀은?	뉴욕 자이언츠	[WHAT]
갈리아인들이 왕으로 추대한 사람은?	포스투무스	[WHO]
"스트라빈스키가 ""스위스 시계 장인""이라고 칭한 인물이 사망한 해는?"	1937년	[WHEN]
팔꿈치에 생긴 구획 증후군을 빨리 치료하지 않을 시, 쓸 수 없게 되는 신체 조직은?	팔꿈치 관절과 손목 관절 사이의 전완부 근육들	[WHAT]
양희가 찬사를 보낸 이는?	초주	[WHO]
시집 《하늘과 바람과 별과 시》를 출간한 사람은?	정병욱	[WHO]
통일된 조지아 왕국의 초대 왕은 누구인가?	바그라트	[WHO]
시라토리가 군사재판에 회부된 죄목은?	A급 전범	[WHAT]
리스 옐친이 비평한 헌법은 어디에 근거하고있나요?	1978년에 제정된 소련 헌법	[WHERE]
싯다르타가 부처에 의해 깨달음을 얻은 후에 헤어진 인물은?	고빈다	[WHO]
베이역이 운행을 시작한 해는 언제인가?	1966년	[WHEN]
마오쩌둥 사상에서 다른 사상으로 바꾼 사람들은 어느 나라 사람인가?	캐나다	[WHO]
워싱턴-스펜서 토지 허용의 재측량을 지시한 도시는?	프린스윌리엄군	[WHERE]
베토벤의 절친이 작품 출간을 위해 부가한 별칭은?	'황제'	[CITE]
도쿄 내 모든 대학교 중 가큐슈인 본 캠퍼스에만 있는 시설은?	승마장	[WHAT]
청소년 유해 매체물로 평가될 시, 방송될 수 없는 시간은?	청소년 시청 보호 시간대	[WHEN]
정부가 한국거래소를 어디로 이전시키면서 서울의 금융지구 순위가 하락하였나?	부산 남구	[WHERE]
아킬레 라티가 종교 문제로 목숨을 잃어도 가고 싶어 했던 나라는?	러시아	[WHERE]
세포 성분과 아크릴 아마이드의 결합을 위해 첨가되는 것은?	열	[QUANTITY]
디그 더그를 움직이는데 필요한 도구는?	레버	[WHAT]
일행들과 함께 션 크러셔를 훔칠 수 있게 퀴 쥬스를 설득한 인물은?	한 솔로	[WHO]
보나보가 제국주의에 대항할수 있는 진정한 힘이라 일컬은 것은?	프롤레타리아 국제주의	[WHAT]
허긴스가 신시내티 샴록스에서 사용한 가짜 이름은 무엇인가요?	'프록터'	[CITE]
가인지경영에 따르면 인재 경영은 무엇으로부터 시작되나?	인재를 발굴하고 적합한 사람을 확보	[WHAT]
처음으로 대통령이 탄핵안이 의결 되었을 당시 이를 반대하던 당은?	열린우리당	[WHAT]
단종이 사약을 받았다는 결정적 증거가 기록된 책은?	선조실록	[WHAT]
신시내티에서 노면전차의 승객 수를 감소시킨 교통 수단은?	자동차	[WHAT]
알바니아가 오스만에 정복당한 이후 아르버레셔인들이 여러 번의 이주를 거쳐 최종적으로 자리를 잡은 곳은?	이탈리아 남부	[WHERE]
자주 국방 가능 국가가 독자적으로 갖추어야 할 GPS나 정보, 정찰자산 같은 자산은?	전략자산	[WHAT]
하나의 요소로부터 만들어져 실패모양인 공추류의 뼈는?	척추	[WHAT]
모리스가 처음으로 특정 당파에 속하게 된 연도는?	1896년	[WHEN]
래깅에 강경한 입장을 보인 기관의 결정에 동의한 인물은?	래그하반 박사	[WHO]
이중창은 언제를 대비한 것인가?	겨울철	[WHEN]
데모스테네스가 투항한 세력은?	시라쿠사 군	[WHAT]
빌 클린턴이 처음으로 선거에서 패배한 연도는?	1974년	[WHEN]
1941년 특설부대에 체포된 항일연군 여자전사는 몇 명인가?	4명	[QUANTITY]
크누트를 자연으로 돌려보내자고 주장한 사람은?	마르쿠스 뢰브케	[WHO]
경성콤그룹의 핵심 인물은?	김삼룡	[WHO]
음형이 A나 B를 벗어나 독자적으로 흘러가는 부분은 몇 마디인가?	322마디	[QUANTITY]
그리스 정부에 올림픽의 재건과 관련한 문서를 보낸 인물은?	파나요티스 수초스	[WHO]
3.1운동이 평화적 선언서 낭독으로 한국의 독립을 알리자는 의도가 감정적 시위로 변질됐다고 말한 사람은?	권동진	[WHO]
아이챌린지 율동놀이 세미나'에서 율동놀이 이외에도 교육받을 수 있는 것은?	바른 생활 습관	[WHAT]
사람들이 sns 해시태그에 오빠딸을 태그하고 누구의 사진을 함께 게시하는가?	'조카'	[WHO]
예르마가 처음 공개된 곳은 어디인가?	마드리드의 에스파뇰 극장	[WHERE]
회고록을 통해 주장한 내용은 몇년도에 부정되었는가?	2008년	[WHEN]
인간에게 심각한 다양한 질병을 초래하는 아레나바이러스의 종의 수는?	여덟 종	[QUANTITY]
제임스 1세의 국적은?	영국	[WHAT]
<조선공로자명감>을 작성한 기관은?	총독부	[WHAT]
카스티요가 비난한 사람은?	고마라	[WHO]
여운형은 누구와 함께 일본으로 갔나요?	장덕수	[WHO]
윤치호가 병으로 인해 쓰러지는 모습을 목도한 사람은 누구인가요?	외손녀 조영숙	[WHO]
폴리포니는 누가 남긴 것인가?	바흐	[WHO]
비트겐슈타인이 병원에서 봉사를 할 수 있도록 한 인물의 직업은?	대학교의 의학 교수	[WHO]
클레멘스 2세가 교황이 되기 전의 행보에 대해 지적한 교황청의 세력은?	교황청 내 개혁파	[WHAT]
시민파빌리온이 위치한 도시는?	광주	[WHERE]
에두아르도 드 필리포의 사망일은?	1984년 10월 31일	[WHEN]
김용식이 맨 처음 활동했던 곳은?	경성	[WHERE]
선 레코드에 의해 프레슬리 음반은 얼마에 팔렸는가?	35,000달러	[QUANTITY]
사림 세력 제거를 모의했으며 이황과 뜻이 일치했던 세력은?	윤원형 일파	[WHAT]
정부가 전후복구재건 사업을 시작된 후에 생긴 기구는 무엇인가?	UNKRA(UN 한국부흥재건단)	[WHAT]
연꽃을 표현한 문양과 함께 광배에서 볼 수 있는 또 다른 문양은?	덩굴무늬	[WHAT]
이고르 댜틀로프가 이끄는 모임에서 가장 먼저 빠진 사람은?-	유리 유딘	[WHO]
알렌이 사람들을 잠들게 하기 위해 사용한 것은 무엇인가?	마술적인 선율	[WHAT]
여름철 열사병을 막기 위해 대한민국 군대는 언제 오후 일정을 시행하는가?	2시	[WHEN]
다양한 지역에 거주하면서 전국 각지에서 살인을 저지른 인물은?	번디	[WHO]
고블린 이전에 케잔을 다스리던 종족은?	트롤	[WHAT]
미군정의 미곡정책에 대한 반발로 일어난 사건을 일으킨 집단은?	조선공산당	[WHAT]
내전에 외국의 간섭이 금지된 것은 언제인가?	1970년	[WHEN]
그레고리오를 라테라노 궁전에 감금한 사람은?	선거인단	[WHO]
미네소타대학의 식품공학과가 개발한 것은?	2차 세계대전 중 미군의 전투식량이었던 K레이션	[WHAT]
게오르크 프리드리히가 헝기리왕에게 오폴레 지역의 통치권을 넘긴해는?	1551년	[WHEN]
고종의 진보적 정책을 다른 사람이 한 것으로 왜곡한 책은 언제 발행되었나?	1940년	[WHEN]
우르바노 5세가 이태리 전역에 십자군 원정을 명령한 해는?	1362년	[WHEN]
잭슨이 생애 첫 전투를 치른 해는?	1776	[WHEN]
아르군의 아들이 자랐던 곳은?	오르도	[WHERE]
요리요시가 무쓰노카미로서의 기한이 끝난 시기는?	고헤이(康平) 5년(1062년)	[WHEN]
도이 류이치는 무엇에 사인했다는 것이 들켜 민주당을 떠나게 되었는가?	‘한일공동선언’	[CITE]
오리지널 약품과 같은 성분의 제네릭 의약품은 무엇을 완료한 이후로 개발 가능한가?	물질 및 용도 특허	[WHAT]
진왕 정의 말을 전해 들은 후 제왕 건은 어떤 행동을 취할 것이라고 다짐하였나?	진나라에 저항	[WHAT]
이규완이 김학우를 죽인 사람이라고 지목한 인물은?	이준용	[WHO]
양산군 하북면 삼수리에 터전을 잡고 양산 이씨의 시조가 된 사람은?	이전생	[WHO]
펨토의 전생은 누구인가?	그리피스	[WHO]
<내 어머니 사는 나라>의 작가가 직접 방문했던 곳은?	금강산	[WHERE]
2020년 직권남용으로 인해 2년형을 선고받았던 사람의 직위는 무엇이었나요?	문화체육관광부 장관	[WHAT]
미디어법 가결선포 권한쟁의를 발생시킨 측은?	여당	[WHAT]
황녹색의 유약이 있는 겉부분이 없어지면 무슨색을 띄는가?	암회색	[WHAT]
인류의 발전과 혼란의 원인을 제공한 주체는?	사탄	[WHY]
교황 갈리스토2세가 종교회의를 개최한 도시는?	랭스	[WHERE]
김구가 안공근에게 야단쳤던 내용이 담긴 책은?	'백범일지'	[CITE]
기혼 남성들이 사용하던 망건은 신체 어느 부위에 착용하는 것인가?	이마	[WHAT]
반도가극단과 더불어 시대극을 조선어로 연극하는 단체는?	라미라가극단	[WHAT]
파비아 대학교에 일반 대학의 지위를 부여한 인물의 직업은?	교황	[WHO]
혁마르파는 무엇을 통해 중핵파와 해방파의 지도자들을 죽였는가?	안게바 공격	[WHAT]
헨드릭스는 어디로 휴가를 갔다가 뇌졸중을 앓았나요?	아칸소주 핫스프링스	[WHERE]
스텝 기후와 사막 지형이 동시에 나타나는 곳은?	알렉산드리아	[WHERE]
페라타 제6군단은 기원전 41년에 누구와 동방에 있었나요?	마르쿠스 안토니우스	[WHO]
네팔의 헌법 수립안 투표에서 기권한 사람의 수는?	66명	[QUANTITY]
이슈타르가 다시 부활한 탐무즈와 함께 머무를 수 있는 계절은?	봄	[WHEN]
<무정>을 기획한 인물이 태어난 도시는?	전라남도 광주	[WHERE]
실존하는 발광체로 만들 수 있는 색깔을 의미하는 단어는?	현실색	[WHAT]
아서 케이스가 조작에 있어서 큰 역할을 했다고 판단한 인물은?	필립 토비아스	[WHO]
장춘단 터가 공원으로 바뀐 해는?	1919년	[WHEN]
상대론에서 운동에너지와 전체에너지의 합은 무엇에 비례하나?	상대론적 질량	[WHAT]
초신성이 폭발할 때 충격파에 의해 압축되거나 열을 받는 것은 무엇인가?	수소 원자	[WHAT]
블레인이 연방 상원으로 선발되기 전까지 맡은 보직이 끝난 해는?	1869년부터 1875년까지	[WHEN]
더우징퉁의 출생 날짜는?	1997년 1월 3일	[WHEN]
북한의 작은 목선이 삼척항에 입항했던 날, 대책 회의가 시작된 장소는?	합동참모본부 지하벙커	[WHERE]
1950년대 항생제과다사용 원인은 미생물이 항생제에 무엇을 가지게 되어서인가?	내성	[WHY]
장면의 깡패 및 혁신세력 소탕 추진 계획을 수포로 돌린 사건은?	5.16 군사정변	[WHAT]
춘추 전국 시대에 널리 쓰였던 화폐는?	도전	[WHAT]
에드워드 3세가 프랑스에서 철수한 것은 무엇 때문인가?	흑사병	[WHAT]
브리오니 협정에 따르면, 슬로베니아는 독립 선포 후 얼마동안 독립 활동을 멈춰야 하는가?	3개월간	[WHEN]
510년 민주정을 성립한 나라와 전쟁에서 충돌하였던 조직은?	펠로폰네소스 동맹	[WHAT]
요셉하이든이 자신의 모든 교향곡을 작성하기까지 얼마나 걸렸는가?	36년	[WHEN]
아미달라 여왕이 팰퍼틴과 손잡고 견제하고자 한 대상은?	무역연합	[WHO]
지방자치단체를 분석한 최초의 보고서는?	2009 지방재정평가	[WHAT]
주찬의 굴복을 받은 사람은?	왕세충	[WHO]
박종철이 검찰총장직에서 물러나는데 결정적 역할을 한 제도는?	공직자 재산공개	[WHAT]
나이지리아에서 민주주의의 날이 처음 생긴 년도는?	1999년	[WHEN]
후한에서 사마씨 가문과 함께 명성을 날린 집안은?	원씨 가문	[WHAT]
2차 국공 합작 이후 국민당이 설립한 기관은?	국민참정회	[WHAT]
"""이와나미 문화인""과 이미지적으로 친화성이 있는 인물의 이름은?"	오에와 오오츠카	[WHO]
옻칠의 종류 중 유일하게 물질의 산화를 막기위해 칠하는 것은?	금태칠기	[WHAT]
1175년에 많은 인부들이 고용되었던 곳은?	지폐 발행 공장	[WHERE]
후아나의 남편은 어디 출신인가?	포르투갈	[WHERE]
모터헤드에서 베이스와 보컬을 동시에 맡고 있는 사람은?	레미	[WHO]
아르타크세르크세스를 독으로 살해한 인물은 누구인가?	바고아스	[WHO]
영지대사가 절을 재건하기 전 절의 명칭은?	웅정암	[WHAT]
승표 부부에 대해 적혀있는 명문은 무엇으로 쓰여진 것인가?	청화안료	[WHAT]
피해자의 왕따 문제를 회피한 사람은 누구인가요?	담임 교사	[WHO]
수천명의 원군이 전투력 강화를 위해 퀘벡으로 파견된 해는?	1776년	[WHEN]
경성제국대학과 홋카이도제국대학의 예과 수업연한이 동일해진 것은 몇 년인가?	1934년	[WHEN]
잉글랜드에게서 돈과 물품, 군인들을 전달할 수 있었던 것은 무엇을 차지했기 때문인가?	제해권	[WHAT]
두영에게 형양을 지키도록 명령한 인물은 누구인가요?	경제	[WHO]
2013년 올레나 소콜로브스키가 출장할 수 없게 된 이유는?	임신	[WHY]
행복한 왕자 동상이 도움을 요청한 동물은?	제비	[WHAT]
빈딘성에서 가장 높은 지역은 어디인가?	안라오현	[WHERE]
베이컨이 발표한 부정적인 원리 중 언어와 관련된 원리는?	시장의 우상	[WHAT]
소련군은 언제부터 핀란드 내륙으로 진격하였는가?	2월 11일	[WHEN]
이슬람교와 힌두교를 혼합해서 새로운 종교를 만든 사람은?	구루 나나크	[WHO]
김용석이 행정소송에 도입돼야 한다고 한 제도는?	의무이행소송'제도	[WHAT]
세계 최초로 능동방어시스템 고안에 앞장선 국가는?	러시아	[WHERE]
제25회 선거에서 중증장애인이 아닌 당선자가 뽑힌 이후에 소속된 곳은?	국민민주당	[WHERE]
통일주체국민회의의 구성을 명시한 법은?	헌법	[WHAT]
프로메테우스에게 고통을 주기 위해 보낸 동물은?	독수리	[WHAT]
펑후섬의 강한 바람 때문에 붙여진 이름은?	풍도	[WHAT]
모라꼿으로 인해 14억 달러의 손해를 본 국가는?	중국	[WHERE]
도조 히데키는 누구의 사망 이후에 비황도파의 중심 인물이 되었나요?	나가타	[WHO]
법주사에서 동쪽으로 약 6km 지점에 위치한 봉우리의 현재 명칭은?	문장대(文藏臺)	[WHAT]
크라우드 펀딩 기술을 통해 뉴스를 제작하는 방식을 국내에 도입한 회사는?	다음카카오	[WHAT]
쓰치야 히로시가 우수 선수상을 받은 해는?	1967	[WHEN]
과거 내무성이 담당하던 토목 업무를 현재 담당하고 있는 기관은?	제2차 세계 대전	[WHAT]
마르카리안이 유소년기의 대부분을 살았던 나라는?	아르헨티나	[WHERE]
뮈라가 축출하려한 사람은?	나폴레옹	[WHO]
황금방울새가 등장하는 소설의 작가는?	도나 타르트	[WHO]
해적의 공격으로 인해 다른 무역로를 찾으려 했던 국가는?	비잔티움 제국	[WHERE]
호라티우스가 깊은 우정관계라고 생각한 인물은?	가이우스 마에케나스(Gaius Maecenas)	[WHO]
옐친 대통령이 의회를 해산하는 계기를 만들었던 집단은?	지지하지 않는 세력	[WHY]
북대서양의 해류는 어느 지역의 해류와 유사한가?	북태평양	[WHERE]
글의 의미를 이해하여 표현하는 방법은 무엇인가요?	의림	[WHAT]
프리츠는 노예들에게 돼지를 놓아준 범인이 나오지 않으면 노예들의 무엇을 뽑겠다고 했나?	눈	[WHAT]
인공 조명이 등장하기 전 광공해를 일으킨 것은?	밤하늘의 달	[WHAT]
피에가 유니버시아드 대신 참가한 대회에서 준결승 상대는?	존 마두로	[WHO]
루르카작전의 해상함들은 그디냐에서 어디로 이동하였나요?	헬 반도	[WHERE]
홍준표 후보는 소양강과 함께 어떤 것을 사례로 들며 녹조가 생기는 이유를 설명하였나?	대청댐	[WHAT]
히브리 성서에서 그리스도를 뭐라 표현했는가?	"""기름 부음 받은 이"""	[CITE]
장면은 아이젠하워에게 새정부의 핵심정책은 무엇이 될 거라고 했나?	경제성장	[WHAT]
벨라사리우스에게 군권을 위임해 이탈리아 정복을 지시한 사람은?	유스티니아누스 1세	[WHO]
달인을 절친으로 만들면 이득을 보는 등급은?	특급	[WHAT]
팔라제국에서 황제들이 신봉한 종교 외에 인정한 종교는?	힌두교	[WHAT]
델핀이 젊은 남자와 같이 녹색 광선을 본 곳은?	해변	[WHERE]
응고되어 있는 코코넛 오일이 녹기 시작하는 온도는?	27 ° C	[QUANTITY]
2007년 에리트레아의 자유 지수를 하위 3등이라고 평가한 기관은?	국경 없는 기자회	[WHAT]
틀라스가 지나 롤로브리지다를 위해 공격하지 않은 대상은?	다국적군에 소속된 이탈리아군	[WHO]
슈트레제만에 대한 여론이 부정적으로 바뀌기 시작한 시기는?	1950년대	[WHEN]
콘스탄티노폴리스 총대주교에게 치명타를 안겨준 칙령을 내린 사람은?	포카스 황제	[WHO]
오류가 많은 게임이라는 낙인이 찍힐 수밖에 없었던 당시 상황은?	웹 환경이 구축되기 전	[WHAT]
불리한 정보를 배제하는 이유에 대해 말한 사람은?	토마스 기로비치(Thomas Gilovich)	[WHO]
유일하게 항원대변이가 발생하는 바이러스 유형은 무엇인가?	인플루엔자바이러스 A형	[WHAT]
이안 스틸이 군에 최적화된 수로라고 말한 호수는?	조지 호수	[WHAT]
갈리폴리 전투를 승리로 이끈 인물은?	타흐신 야즈즈 준장	[WHO]
1754년에 식민지 쟁탈전에서 승기를 잡은 국가는?	프랑스	[WHERE]
개미가 자신의 목적지를 찾기 위해 보는 것은?	태양	[WHAT]
이교주 어머니의 성씨는?	박씨	[WHAT]
네루다가 사망할 당시 군사혁명을 일으킨 사람의 이름은?	아우구스토 피노체트	[WHO]
초창기 전화번호의 길이는?	두세자리	[QUANTITY]
블레인이 판매자를 대신하여 판 상품은 무엇인가?	철도의 채권	[WHAT]
꽃잎 형태의 판 3장을 끼운 다음 13각으로 만들어진 손잡이의 위치는?	뚜껑의 꼭지	[WHERE]
십자군은 카르부가 군대에 대처하기 위해 어디를 함락시켰는가?	안티오키아	[WHERE]
김장생의 할아버지가 맡았던 직책은 무엇인가?	지례현감	[WHAT]
이오에 있는 산들 중 가장 높은 산은 무엇인가?	사우스 보사울레 몬테스	[WHAT]
프라다 지아니니의 후임이 구찌의 디자인 스튜디오에 온 해는?	2002년	[WHEN]
중국 기자들은 누구의 이름을 본떠 최강희의 별명을 지어주었나요?	청나라 시대의 강희제	[WHO]
법칙은 무엇을 토대로 생성되는가?	데이터	[WHAT]
윌리엄 3세와 메리 2세를 혼인시킨 인물은 누구인가?	네덜란드 총독 빌렘 3세(제임스 2세의 조카)	[WHO]
마렉 아스라프의 사후 우웨이스 1세가 탐내기 시작한 것은?	츄판 왕조의 영토	[WHAT]
배우 얼굴의 형태를 많이 바꾸지 않고 간단하게 하는 화장은?	직선적인 무대화장(straight make-up)	[WHAT]
차홍녀와 황철이 만든 극단이 설립되었던 해는?	1939년	[WHEN]
루이지애나흙파는쥐 다음으로 큰 동부흙파는쥐는?	아트워터흙파는쥐	[WHAT]
토르고가 하던일을 이어받은 사람을 연기한 배우 이름은?	해롤드 워렌	[WHO]
안시성을 격파하려 했지만 실패한 국가는?	당나라	[WHERE]
해병대 자선 마라톤'행사는 며칠에 열릴 계획이었는가?	17일	[WHEN]
장덕의 세 번째 정규 음반에 수록된 자작곡 수는?	9곡	[QUANTITY]
누가 적벽대전에서 승리했는가?	손권·유비 연합군	[WHO]
전기와 전자가 서로 유도하는 원리를 활용해 만든 물건은?	전동기	[WHAT]
오리온 함이 배정받은 위치는 어디인가?	북부 사단의 뒤쪽	[WHERE]
사람들에게 절대적으로 알라를 믿기를 가르친 사람은?	무함마드	[WHO]
박창숙의 막내아들 이름은?	박재훈	[WHO]
니콜라옙스크 사건을 주동한 빨치산의 리더 중 자유단 세력에 희생된 이는 누구인가?	야코프 트랴피친	[WHO]
김순이 일리 지방을 공격할 때라고 생각한 이유는?	러시아 - 투르크 전쟁이 발발	[WHY]
장괴가 진유를 살해하게 된 빌미를 초래한 사람의 이름은?	조광(趙匡)	[WHO]
이 초상화는 얼굴의 어느 방면을 그린 것인가?	왼쪽	[WHAT]
하이다 과이는 하이다언어로 어떻게 해석되는가?	"""사람들의 섬들"""	[HOW]
19세기에 박해를 받음에도 불구하고 동학과 함께 백성들 사이에 전파된 종교는?	서학(천주교)	[WHAT]
옵발덴주는 언제부터 독자적인 발언권을 가지게 되었는가?	1999년	[WHEN]
뉴욕에서 폭발이 일어났을 당시 폭발이 발생했다는 사실을 알린 사람은 누구였나?	J. 피터 도널드	[WHO]
프리웨어와 셰어웨어의 설치 시 공통점은?	무료	[WHAT]
사민당이 화력 발전보다 친환경적이라 주장하는 것은?	원자력 발전	[WHAT]
장경근이 일본으로 밀항했다는 사실을 알린 언론사는?	국제신보	[WHAT]
페르디난도 2세의 전 부인이 낳은 자식의 이름은?	프란체스코	[WHO]
대통령 선거에서 이기기 위해 어업협정 체결 사실을 대중에게 늦게 알린 인물은?	박정희	[WHO]
나히체반 칸국에 대한 관할권은 어느 나라로 옮겨졌나?	러시아 제국	[WHERE]
정원의 5분의 1을 소프트웨어 특기자로 뽑는 단과대가 생겨난 해는?	2017년	[WHEN]
흑요석이 사용된 것은 구석기 시대 어느 시기인가?	후기	[WHEN]
식민통치기간동안 이뤄진 서구화는?	기독교의 확산	[WHAT]
도쿠가와 이에야스는 어떤 전쟁 때문에 소마 가문을 서군으로 간주했나요?	세키가하라 전투	[WHAT]
보소 5세와 이르멘가르트의 결혼을 주선한 인물은 누구였나?	오툉의 리첼다	[WHO]
존 게일 파커 2세가 로고를 만들어준 회사는 어디에 있나요?	테네시 주 내슈빌	[WHERE]
드라마 닥터 후를 방영한 방송사는?	BBC	[WHAT]
기면증의 가장 유력한 발병 원인은?	바이러스 감염	[WHY]
두만강 지역이 처음으로 주목받은 시기는 언제인가?	1930년대	[WHEN]
군 정부의 권한 남용을 지적한 기관은?	국제투자분쟁해결센터	[WHAT]
다이묘가 새로이 만들어지는 조건은?	인접한 영지를 다스리는 다이묘가 1명 이하인 경우	[WHAT]
토마스가 캔터베리의 대주교로 활동하도록 명령한 인물은 누구인가요?	헨리 2세	[WHO]
"서적 ""논고""를 영문으로 옮긴 사람은 누구인가?"	칼스 케이 오그던	[WHO]
오키노쿠니에 신탁으로 신풍이 적의 배를 침몰시켰다는 소문이 돈 때는?	엔기 3년 7월	[WHEN]
불경에서 석가모니의 말씀을 전파하는 새는?	가릉빈가	[WHAT]
높은 수준의 대회에서 피스톨 그립이 가장 빈번히 사용되는 종목은?	플뢰레	[WHAT]
미국의 일광절약시간제 기간이 늘어나기 시작한 해는 언제인가요?	2007년	[WHEN]
시분할 운영 체제를 통해 사용자들에게 분배되는 것은?	컴퓨터 자원	[WHAT]
요동도행군의 선발 기병부대 숫자는?	4천 명	[QUANTITY]
테런스 엄마의 직업은?	교도관	[WHO]
공세를 실패하기 전 북한군 전략의 중점은?	공세 위주	[WHAT]
이순몽 장군의 자택이 설립된 시기는?	세종 15년(1433)	[WHEN]
소비자 행동론은 어떤 학문에 포함된 이론인가요?	경영학	[WHAT]
1991년까지 한국에 진출한 맥도날드의 지점은 모두 몇 곳인가?	7곳	[QUANTITY]
함재기는 어디서 출동대기를 하는가?	항공모함	[WHERE]
브라이언메이는 어느 기업의 픽업을 구매했나요?	Burns사	[WHAT]
암스테르담에 시청을 세운 인물은?	캄펜	[WHO]
결혼정보회사 선우의 설립자의 통명은?	'중매 대통령'	[CITE]
개인 사용자가 각자 사용할 데이터베이스를 디자인하는 것을 쉽게 해준 프로그램은?	매킨토시와 도스 상에서 ‘설정 가능한’ 플랫 파일 데이터베이스 응용 프로그램	[WHAT]
1916년, 공유 결합이 두 원자가 전자쌍을 함께 나눠 생기는 현상이라는 것을 알아낸 인물은?	길버트 뉴턴 루이스	[WHO]
자미토프는 델라즈 분쟁을 근거로 무엇을 만들었나요?	특수부대「티탄즈」	[WHAT]
과거의 희곡작품을 주로 취급하는 장르는?	뮤지컬	[WHAT]
임헌영은 어느 기관에 소속되어 있는가?	민족문제연구소	[WHAT]
강희제가 소박한 사람이라며 칭찬한 인물은?	부베	[WHO]
동인도회사를 해체한 나라는?	영국 정부	[WHERE]
상숙이 본인의 당선을 기원하며 빌었던 대상은?	돌탑	[WHO]
1945년 8월 하순 당시 조만식이 있었던 도시는?	평양	[WHERE]
크리올 엘리트들이 스페인 의회에게 요청한 점은 모두 몇 개인가?	네 가지	[QUANTITY]
밀본은 왕궁에서 누구를 대신하여 왕을 치료하였나요?	흥륜사(興輪寺)의 승려 법척	[WHO]
단독으로 대기권에 진입할 수 있는 기술을 처음 소유한 기체는?	건담	[WHAT]
왕이 동명을 죽이려하자 동명이 도피한 지역은?	부여	[WHERE]
ㄱ씨가 코로나 감염 여부를 무료로 확인받기 위해서는 어느 지역에서 확인받아야 하는가?	전북 전주	[WHERE]
첼로와 함께 발전 조짐 이후 번갈아 연주하는 악기는?	클라리넷	[WHAT]
임한경이 변호사 개업을 하기 전 직위는?	서울고등법원장	[WHO]
중상주의 시기에 콜베르는 어떤 국가의 산업을 보호하려 했나요?	프랑스	[WHAT]
경희대학교에 들어가 수비를 전담하게 된 선수의 키는?	170cm	[QUANTITY]
천연두와 비슷하여 흔히 헷갈리는 병명은 무엇인가요?	수두	[WHAT]
상주시 화북면에서 문장대까지 걸리는 시간은?	약 1시간 30분	[WHEN]
마라의 죽음'의 복제품은 몇 년도부터 제작되기 시작했는가?	1793	[WHEN]
이유립씨가 글을 싣기 시작한 잡지사가 창간된 시기는?	1968년	[WHEN]
훈족이 교황을 만나고 돌아가던 순례자들을 공격한 곳은?	쾰른	[WHERE]
사고의 원인을 밝히는 데에는 어떤 사람들이 참여했는가?	해양 전문가	[WHY]
인간세계에서 볼바는 누구의 역할을 대신한다고 여겨졌나요?	프레이야	[WHO]
호쿠토는 업무전화를 받고 어디로 가버렸나요?	철도박물관	[WHERE]
리켈메가 대표팀에 들어갈 수 있었던 기량을 보여준 경기는?	FIFA 세계 청소년 축구 선수권 대회	[WHAT]
삼척기줄다리기에서 속닥기줄은 누가 잡는 줄인가?	어린이들	[WHO]
아시아 여자 농구 선수권 대회는 몇 년에 열렸는가?	1984년	[WHEN]
윤직선의 아들 이름은?	윤극영	[WHO]
재개발 이전에 프레쉬킬스 매립이었던 곳은?	프레쉬킬스 공원	[WHERE]
유럽 연합을 만들 때, 중요하게 여겨야 할 가치가 서술되어있는 조항은 어디인가?	제2조	[WHERE]
우주정거장이 추락하는 사건의 원인은 무엇인가?	지나친 우주 개발의 경쟁	[WHY]
란돌포가 전 재산을 투자한 상품으로 하고자 한 일은?	무역	[WHAT]
제나라의 실질적인 권력자는 누구였는가?	전영	[WHO]
고조선의 세력 축소에 대한 내용이 나와있는 책은?	위략	[WHAT]
연예인들은 성우에 비해 어떤 교육을 받지 못해 미숙한 연기를 보여주는가?	전문적인 성우 및 발성 교육	[WHAT]
튀코 브라헤는 프레데리크 2세가 사망한 후 어디로 이주하나요?	프라하	[WHERE]
현재 선수촌 형태의 시설의 시발점은 무엇이었는가?	미국 로스엔젤레스에서 열린 1932년 하계 올림픽	[WHAT]
지미 카더는 선거 공약으로 무엇을 내세웠는가?	신분보장 조항의 입법	[WHAT]
레오 6세에 의해 감금당하여 살해된 인물은 누구인가요?	레오 6세의 전임자인 요한 10세	[WHO]
모아이를 이루는 돌의 종류는 무엇인가?	화산암	[WHAT]
다 다른 계정으로 게시물을 올려도 무엇이 동일하다면 모든 게시물의 IP 주소는 동일한가?	컴퓨터	[WHAT]
폴란인의 후손들은 오늘날 뭐라 불리는가?	폴인	[WHAT]
아버지를 존중하지 않았던 인물은 누구인가요?	킴	[WHO]
입방 밀집 구조 보다 간격이 더 큰 구조는 무슨 모양을 띄고 있나요?	정육면체	[WHAT]
이오의 표면이 산으로 둘러싸여 있는 것은 어떤 현상 때문인가?	규산염 지각에서 벌어지는 압축	[WHAT]
에너지 기본권의 의미를 포함하는 법 조항은?	에너지법 제4조 5항	[WHAT]
청화백자병에서 당시의 새로운 유행양식과 높은 미적감각을 엿볼수 있는 표현 방식은?	사방연속 만자문	[WHAT]
사쿠라가 성장할 때 스피넬 선을 만든 이유는?	자신에게서 크로우 리드를 찾지 않게 하려고	[WHY]
발터 카우프만은 《지하실의 수기》를 뭐라 표현 했는가?	"""실존주의를 위한 최고의 서곡"""	[CITE]
척추측만증을 앓는 사람의 척추에 부정적인 영향을 끼치는 힘은 무엇인가요?	중력	[WHAT]
웹 브라우저의 취약점을 최소한으로 보완할 수 있는 방법은?	브라우저 소프트웨어 업데이트를 유지함	[WHAT]
한국의 주먹밥과 비슷한 일본의 음식은?	오니기리	[WHAT]
영국 국방부가 공식적으로 만들어진 해는?	1940년	[WHEN]
케네스 크레이크가 심리학에 영향력을 미친 대륙은?	유럽	[WHAT]
심우섭을 모티브로하여 만든 인물이 등장하는 책 제목은?	《무정》	[CITE]
혼자가 된 소영의 옆에서 큰 힘이 되어준 사람은?	어머니	[WHO]
임산부가 태몽을 꾸는 시기는 주로 임신전후와 또 언제인가?	분만직전	[WHEN]
1978년 세계사격선수권대회에 출전하는 사람들이 머물렀던 곳은?	워커힐아파트	[WHERE]
에르빈의 죽음을 확인한 사람은?	한지	[WHO]
옥타비아누스는 사모스섬에서 무엇으로 만들어진 선물들을 받았나?	황금	[WHAT]
콜초프는 인터뷰에서 라이오넬 크랩을 살해한 보상으로 무엇을 받았다고 했나?	적성훈장	[WHAT]
일부 북한 사람들이 북한에 송환된 재일동포들을 낮추어 부른 단어는?	'째포'	[CITE]
본존불의 하체의 가운데 부분에서 볼 수 있는 것은?	바지 자락	[WHAT]
시미즈 건설이 기밀을 발설하여 공사에 대한 입찰을 하지 않았던 집단은?	서일본 고속도로	[WHAT]
페터 스토이베산트가 포트 캐지미어를 세웠던 장소의 현재 이름은 무엇인가?	뉴캐슬	[WHERE]
번오기의 진군에 의해 살해 당한 대장은 누구인가?	호첩	[WHO]
스파르타스가 그리스의 총대주교를 만나게끔 도와준 인물은?	니코데모스 사리카스	[WHO]
경정수익금으로 환경보호운동과 인류박애운동을 한 단체는?	재단법인 일본선박진흥회(현재의 일본재단)	[WHAT]
진공흡인 유방생검술에서 1회에 많은 양의 조직을 얻을 때 사용하는 도구는?	굵은 바늘	[WHAT]
경제적 의미의 국토란 무엇인가?	국민생산 활동의 기반	[WHAT]
시아파가 다른 종교의 찬동을 얻기 시작한 해는?	2006년	[WHEN]
최은영의 등단 작품은?	《쇼코의 미소》	[CITE]
기체와 얼음에 둘러싸여진 c 중심핵의 모습와 유사한 모양새를 띄고 있는 행성은 무엇인가?	해왕성	[WHAT]
군주로부터 임명되었던 각료들은 퇴임 후 어떤 직위를 맡았는가?	자문관	[WHAT]
1940년부터 독일과 함께 연합군을 공격한 나라는?	일본	[WHERE]
빅·잠을 부순 부대는?	화이트 베이스 대	[WHAT]
비봉산성은 누구의 침략을 방어하기 위해 지어졌나요?	왜구	[WHO]
북한은 평양에 무엇이 있기 때문에 고조선의 도읍이 현재의 평양시라고 주장하는가?	단군릉	[WHAT]
도기가 도입되기 전부터 사용되던 요리 방법은?	굽기	[WHAT]
스파르타와 아테네 사이에 일어난 무력적인 분쟁은?	펠로폰네소스 전쟁	[WHAT]
클라이드 톰보가 명왕성을 찾아냈던 장소는?	로웰 천문대	[WHERE]
신탁통치 오보사건은 어떤 신문사와 관련되어있나요?	동아일보	[WHAT]
로잔의 옛 명칭인 라우소니움은 어느 시대에 붙여진 것인가?	로마 제국	[WHEN]
사람들의 보편적인 연대를 붕괴시키고 일부만 단결시키는 것은 무엇인가?	국가	[WHAT]
합동 조사반과 같은 달에 조사 결과를 발표한 기관은?	전주지검	[WHAT]
1932년 11월에 조동호를 상해로 보내라고 명령한 인물은 어디에 있었나요?	중국	[WHERE]
코드링턴이 바스 훈장을 수여받았던 때는 언제인가?	1815년	[WHEN]
동시에 2발을 쏠 수 있는 무기 중 포물선 형태로 공격하는 것은 무엇인가?	횃불	[WHAT]
의사-석유 교환 협정으로 이득을 본 베네수엘라의 정책은?	바리오 아덴트로 미션	[WHAT]
"학교 지휘부가 ""혼란을 피하여 침착하게 한강을 넘어라""라고 지시를 내린 이유는?"	생도들의 전멸	[WHY]
윤치호는 원산에 사는 사람들이 무엇에 대해 무지하다고 하였나?	공공정신(에티켓)	[WHAT]
한국과학기술원에서 반도체 집적 회로 제작 설비를 갖추기 위해 투자한 기간은?	3년	[WHEN]
예수에게 자신의 삶을 바친다는 의미에 포함되어 있는 물건은?	자기 십자가	[WHAT]
코우테츠가 전투에 사용된 건 언제까지인가?	1888년	[WHEN]
호르스트 슈만이 미군의 포로에서 풀려난 연도는?	1945년	[WHEN]
김진양을 좌우사의 직위에서 물러나게 한 조직은?	사헌부	[WHAT]
줄기 네발동물은 줄기생물군에서 무엇을 제외한 종들인가?	크라운 그룹	[WHAT]
하산 부즈루그가 쿠첵에게 패배 후 쫓겨난 곳은?	바그다드	[WHERE]
2000년 일본 중의원 의원 총선거 당시 사사키의 경쟁자는?	기카와다 도오루	[WHAT]
창녕 포교당 목조여래좌상과 대구 동화사 대웅전 목조삼세불좌상 중 먼저 만들어진 것은?	대구 동화사 대웅전 목조삼세불좌상	[WHAT]
수만 명의 사람들이 아바시제의 사퇴를 요청하러 간 곳은?	바투미	[WHERE]
안중근의 동생이 실종된 지역은?	충칭	[WHERE]
노부스 호모들의 원래 신분은?	평민	[WHO]
풀 팽창식 사이클은 다른 사이클과 비교했을 때 어떤 문제를 가지고 있는가?	고추력 엔진에 적합하지 않은 것	[WHAT]
정치에 자신이 영향력을 행사할 수 없다고 생각하는 사람들을 분석한 인물은?	로버트 달	[WHO]
코알라가 하루 대부분을 잠을 자는 데 영향을 끼친 것은?	유칼립투스	[WHAT]
진왕 정 15년 진나라가 조나라를 공격할 때 가장 먼저 공격한 지역은 어디인가?	낭맹(狼孟)	[WHERE]
아노머가 안정적인 상태가 되기 위해 아노머기와 고리의 다른 작용기 사이에서 이루어지는 반응은 무엇인가?	수소 결합	[WHAT]
쿼텃이 중동 평화 로드맵으로 이스라엘과 팔레스타인 사이에서 끝나기를 바라는 것은?	유혈 사태	[WHAT]
2001년 노스 지역 선거에서 459표를 받은 인물이 인터넷에서 사용하는 명칭은?	차이나	[WHAT]
아 바오아 쿠를 다시 침략하도록 지휘한 사람은?	연방군 수뇌	[WHO]
비잔틴 제국의 황제와 누르 앗딘이 평화협정을 맺은 지 3년 후에 베르트랑은 어떤 전쟁에 참전했나?	이집트 원정	[WHAT]
사패산 송추계곡에서 발원한 하천의 이전 명칭은?	곡릉천	[WHAT]
네델란드가 경제적인 면 뿐 아니라 문화적인 면으로도 가장 전성기를 이룬 시기는?	17세기 전반	[WHEN]
지금까지도 전통도자기를 제조하는 도예가들 다수가 살고 있는 곳은?	단양군 대강면 방곡리 일대	[WHERE]
프랑스가 베트남을 공격한 명분은?	기독교에 대한 탄압	[WHAT]
라오스에서 독립선언이 이루어진 해에 심각한 식량 부족을 겪은 나라는?	베트남	[WHERE]
에렌을 조사병단으로 투입하기 위해 에렌을 때렸던 인물은?	리바이	[WHO]
오드리의 남지친구의 직업은?	CIA 요원	[WHO]
우에노가 공식적으로 사과받은 인물의 직위는?	시장	[WHO]
펠리페는 무엇을 조종하는 훈련을 받았나요?	군사 헬리콥터	[WHAT]
기원전 25년에 킬리키아의 서쪽 땅을 다스린 인물은?	카파도키아의 아르켈라오스 왕	[WHO]
전염병이 에티오피아에서 시작했다고 기록한 사람은?	투키디데스	[WHO]
진양서류가 화석 상태로 남아있을 가능성이 희박한 원인은 무엇인가?	부서지기 쉬운 뼈	[WHY]
프랑스군의 옆을 공격하여 그들을 퇴각시켰던 집단은?	하이랜더 연대	[WHAT]
국가운영 체제가 국가자본주의로 가게된 것은 어느 계급의 변질 때문인가?	노동자 집단	[WHAT]
노르웨이어에 많은 영향을 준 언어가 속한 그룹은?	동스칸디나비아어	[WHAT]
승부 조작에 관한 신고를 받은 곳은?	KBO	[WHERE]
선고 된 형의 집행을 뒤로 미루는 것을 무엇이라고 하는가?	집행유예	[WHAT]
헬렌 레너드 헤이가 아들이 3살일 때 머물렀던 곳은?	일리노이주 워소	[WHERE]
족장에서 황제로 진급한 인물이 위미르를 깔보며 불렀던 명칭은?	"""나의 노예"""	[CITE]
아얌을 사용하던 사람은?	부녀자들	[WHO]
김홍륙이 지냈던 벼슬 중 가장 높은 직위를 가진 벼슬의 이름은 무엇인가?	학부협판	[WHAT]
후지타카가 나데시코와 혼인할 당시 후지타카의 나이는?	25세	[QUANTITY]
서경우는 언제 처음 관직에 올랐나?	1603년	[WHEN]
토라에게 작은 린트부름을 선물한 인물은?	헤라우드	[WHO]
인권과 티베트 운동가 연합이 뉴욕에서 집회를 열어 석방시키고자 한 사람은?	돈둡 왕첸	[WHO]
최열이 사도가 되기 위해 지불한 금액은?	오백만 금	[QUANTITY]
많은 사람들에게 교도소의 문제점을 알린 인물은?	토마스 오 피어크	[WHO]
미에슈코 1세의 왕비의 국적은?	보헤미아	[WHAT]
그로스테스트가 박탈 이론을 이용해 순수 결핍으로 생각했던 단어는?	추	[WHAT]
감염내과 전문의들은 어떤 병의 원인을 알아내는 것에 도움을 주는가?	열병	[WHY]
사단장이 포로의 진술 내용을 재확인하라고 명령한 사람은?	연대장	[WHO]
리처드 액셀이 과학에 대한 태도를 바꾼 기관은 어디인가?	컬럼비아대학교안의 유전학 연구소	[WHERE]
저온 보관 기술이 개발되지 않았을 당시, 브로콜리보다 더 많이 유통된 것은?	콜리플라워	[WHAT]
세금 납부 영수증이 여권의 기능을 대신할 수 있는 나라는?	중세 아랍 제국	[WHERE]
아디아포라와 선악이 서로 무관하다고 주장한 사람은 누구인가?	제논	[WHO]
이셴 층을 두가지 방법으로 측정했을 때 다른 결과가 나온 부분은?	최하부 지층	[HOW]
기후 변화 대응 체계 해소 취지에 선구할 수 있는 방안으로 대두되는 농업 장소는?	주거 및 상업시설 복합 건축물의 상업 지역 부분 옥상 등지	[WHERE]
공장제 수공업에서 기계제 대공장으로, 자본주의적 생산관계가 형성되는 전환점을 무엇이라고 하는가?	산업혁명	[WHAT]
오마의걸의 ‘violet 버전‘ 음반 표지의 배경은 무엇인가?	불꽃놀이가 벌어지는 밤하늘	[WHAT]
1967-68 시즌의 우승팀은 누구인가?	뉘른베르크	[WHO]
노르드인 탐험가들이 북대서양 해안에서 발견한 땅 중 가장 늦게 발견된 곳은?	뉴펀들랜드 섬	[WHERE]
옛날 어부들이 육수를 만들기 위해 사용했던 것은?	바닷물	[WHAT]
최성면, 이원용과 함께 팀을 다시 꾸린 인물은?	김원겸	[WHO]
로크리누스가 훔베르를 살해한 방법은?	익사	[WHAT]
정조가 태어난 해는?	1752년	[WHEN]
제임스 로건에게 땅을 판 펜실베이니아 지역의 원주민은?	레나페족	[WHO]
공정 러시아당에서 빈부격차를 줄이기위해 채택해야 한다고 주장하는 세제는?	누진세	[WHAT]
성 베네딕도가 수도사들에게 반드시 읽어야 한다고 권하는 것은 누구의 저서인가?	요한 카시안	[WHO]
유란시아 재단은 2000년에 몇 권의 책을 팔았는가?	38,000	[QUANTITY]
금강 자전거길의 종착지는 어디인가?	전라북도 군산시 금강하구둑	[WHERE]
세계인권선언과 국제인권규약을 비교했을 때 어떤 것이 더 세세한 규약을 담고있나?	국제인권규약	[WHAT]
청주시에서 학생요금은 무엇에 따라 달라지나요?	“신분”	[CITE]
키루스의 애인 아스파시아의 원래 이름은?	미루트	[WHAT]
엔베르 호자와 같이 종속지의 혁명이 인민민주주의의 혁명이라고 강조한 자는?	마오쩌둥	[WHO]
인도에서 제일 많이 알려진 악기의 가장 일반적인 형태는?	타라프다르 시타르	[WHAT]
텐스카타와의 개명전 이름은?	랄라웨티카	[WHAT]
방실이가 출생한 지역은 어디인가요?	인천광역시 강화	[WHERE]
박근혜 후보 대선 캠프에서 윤씨의 직책은?	재외선거대책위 공동위원장	[WHO]
신일고는 어디에 있는가?	서울 강북구	[WHERE]
자신의 이익을 위해서 옳지 못한 일을 주저없이 행동에 옮기는 이를 뭐라 하는가?	소시오패스	[WHAT]
위대한 탄생은 초기에 어떤 프로그램을 모방했다고 비난을 받았나요?	엠넷의 공개 오디션 프로그램 슈퍼스타K 2	[WHAT]
강재구 대위의 사망일은?	1965년	[WHEN]
잘못된 보도로 인해 신탁통치반대운동이 찬반으로 나뉘어지게 한 언론은?	동아일보	[WHAT]
가옥을 디자인하고 만들었던 인물은?	전명기	[WHO]
샴스 알딘의 형제는 누구인가?	아부 이샤크	[WHO]
가격탄력성의 정도를 표현을 위해 기준이 되는 숫자는?	1	[QUANTITY]
잉글랜드군은 누구를 미제리코르테로 찔러 죽였는가?	부상이 심해 옮기기 어려운 기사	[WHO]
관리의 비리와 재산 은닉 현상을 없애준 화폐는?	녹슨 쇠 화폐	[WHAT]
칼 구스타브 에밀 만네르헤임 남작이 지원하는 자원 봉사단은 어디로 보내졌나?	노르웨이	[WHERE]
테바이는 권력을 잃고난 뒤 누구에게 복종하게 되는가?	아테나이	[WHO]
랑선에서 퇴각 결정을 내린 자가 받은 조치는?	보직 해임	[WHAT]
이고르 댜틀로프를 중심으로 만들어진 탐사대에서 다수를 차지한 성별은?	남자	[WHAT]
유명한 펑크 베이시스트의 일부는 어떤 방식으로 연주하였나?	전형적인 핑거스타일 방식	[HOW]
아살 북서쪽에 유도 폭탄이 떨어진 해는?	2014년	[WHEN]
크리스티 역은 어느 도시에 있는가?	토론토	[WHERE]
이남호 소령의 제3대대가, 제2대대가 진천으로 간 이후에 간 곳은?	병암리	[WHERE]
후각과 청각이 발달한 진도개의 탁월함은 무엇에 적합한가?	사냥	[WHAT]
손상 된 후 재생 가능한 거위와 오리의 신체 부위는?	부리	[WHAT]
교황 베네딕토 16세가 영국에서 가장 먼저 찾아간 곳은?	스코틀랜드	[WHERE]
튀니스의 왕이 딸의 정략결혼을 원활히 진행하기 위해 도움을 청한 사람은?	귈리엘모	[WHO]
연방군 요새를 공격하기 위해 티안무 함대가 준비한 것은?	「솔라 레이」	[CITE]
1950년 신강지역에서 최고 군 지도자 지위에 있었던 사람은?	왕진	[WHO]
흰다리새우와 블랙타이거새우는 양식 새우의 몇 퍼센트를 차지하나요?	80%	[QUANTITY]
승려들의 참여로 붙기 시작한 시위의 별칭은?	사프론 혁명(Saffron Revolution)	[WHAT]
주민등록 상에서 신고, 직권조치, 이의신청, 호적신고의 방법으로 기입된 내용을 변경하는 것을 무엇이라고 하는가?	등록의 정정	[HOW]
니클라스 쥘레의 팀은 경기에서 몇 km를 뛰었는가?	115km	[QUANTITY]
리비아 과도국가평의회가 공식적으로 합법정부로 받아들여진 날은?	2011년 7월 15일	[WHEN]
빌리에르 군이 오스위고 요새로 접근할 때 몽칼름은 어디로 가고 있었는가?	온타리오 호	[WHERE]
서천리 당산의 남자 돌장승의 이름은?	방어대장군	[WHAT]
카르타즈가 처음 발행된 것은 몇년도인가?	1502년	[WHEN]
토우다만 족으로 알려진 종족과 싸운 것은 누구인가?	스타다코난족	[WHO]
에드워드 오헤어 대령이 제로센을 상대로 탄 기체는?	F4F 와일드캣	[WHAT]
종업원의 자율성을 증가시키기 위한 보상 방법은?	내재적 보상	[WHAT]
트라벨시가 멘체스터 시티 FC로 이적한 해는?	2006	[WHEN]
기온이 높은 동굴 내부에 서식할 수 있는 것은?	이끼식물	[WHAT]
전국반생체실험협회의 부위원장을 맡은 사람 중 여자의 비율은 어느정도였는가?	4분의 3	[QUANTITY]
1949년 대한식량공사 이사들의 퇴임은 무엇 때문인가?	비리 사건	[WHY]
핀란드의 대표단이 1940년 3월 6일에 향한 곳은?	모스크바	[WHERE]
다른 동물과 다르게 호모 사피엔스만 가지고 있는 특징은?	언어의 사용	[WHAT]
맨 처음 표현주의영화들이 이상한 배경을 사용하게 된 이유는 무엇이 모자랐기 때문인가?	자금	[WHY]
그래픽 사용자 인터페이스는 어떤 모양으로 마우스 위치를 나타내나요?	화살표	[WHAT]
윤치호가 일제의 '우호적인 식민통치'를 기대했다고 비판한 사람은?	정운현	[WHO]
시마즈 도시히사를 참수한 사람은?	하라타 진지(原田甚次)	[WHO]
대중을 통제하기 위해 위정자들의 수단이 되기도 한 것은?	종교	[WHAT]
특별보고관은 특별한 임무와 관련된 인터넷 문제를 해결할 때 어떤 사람이 참여하기를 바라나?	특별 절차 위임 소지자	[WHAT]
신돈을 죽이고자 했던 인물은?	무장인 정세운	[WHO]
서재필은 어느 궁을 지켰는가?	경우궁	[WHAT]
킹이 변호사로서 자문을 해준 의원은?	윌리엄 해서웨이	[WHO]
로마 시민권 부여에 관한 규정을 발표한 것은 언제인가?	212	[WHEN]
그린'박사는 누구로부터 정글을 구하려고 하는가?	연구소 소장	[WHO]
고구려와 싸우기 위해 배를 만들도록 지시했으며 바다 길을 통해 침략을 도모한 인물은 누구인가?	당 태종	[WHO]
밴드에게 창작적으로 제약을 준 인물은?	프로듀서 마이클 베인혼	[WHO]
"""요원 호출"" 영상에 출연하는 캐릭터는?"	윈스턴	[WHAT]
행성들이 타원을 그리며 태양 주위를 돈다는 사실을 정리한 이론은?	요하네스 케플러의 행성운동법칙	[WHAT]
1102년에 파스칼 2세에 의해 파문당했던 인물이 1년 뒤에 선언한 것은?	십자군원정	[WHAT]
스코틀랜드에 봉건제가 도입됐을 것으로 추측되는 시기는?	1052년	[WHEN]
백기를 든 북한군에 대해 사격을 중지시킨 사람은?	제2대대장 김종수 소령	[WHO]
요한 9세는 무엇을 더 튼튼하게 만드는 것이 맞다고 판단하여 람베르토 2세를 지지했는가?	교황청과 제국의 관계	[WHAT]
바키를 불합격하게 만든 제도는 누구를 위한 것이였나요?	소수인종 학생	[WHO]
크렘린 궁과 함께 러시아를 대표하는 겨울 궁전이 위치해 있는 지역은 어디인가?	상트페테르부르크	[WHERE]
시오야슌이 붕대를 감고 촬영한 이유는?	왼손이 부러졌기 때문	[WHY]
이계록이 기업인으로 활동을 시작하던 시기에 근무한 지역은 어디인가?	평창군	[WHERE]
웰시의 전임 1소대장은 누구인가?	리처드 윈터스	[WHO]
방글라데시와 벵골만 서쪽 지역에서 점심 식사 후에 잠깐 자는 잠을 무엇이라고 부르는가?	bhat-ghum	[WHAT]
주민들의 반발로 인해 태조 왕건은 어디를 떠나게 되나요?	철원	[WHERE]
키미 라이코넨과 데니스는 누구 앞에서 계약을 했는가?	페라리의 보스 장 토드	[WHO]
구두충이 숙주의 창자에 붙을 수 있는 이유는 주둥이에 무엇이 있기 때문인가?	갈고리 모양의 가시	[WHY]
국제 올림픽 위원회로부터 토미 스미스와 함께 쫓겨난 인물은?	존 칼로스	[WHO]
브란스톡 나무의 검을 뽑는 자가 검의 주인이 될 것이라 말한 인물은?	오딘	[WHO]
12월 12일에 호트군의 선봉이었던 사단의 하루 이동 거리는?	20km	[QUANTITY]
위미르와 함께 엘디아 제국을 세운 사람은?	프리츠	[WHO]
장갑 두께가 두꺼워질수록 무게 증가로 오는 문제는?	전차 기동력 감소	[WHAT]
장승은 무엇이 들어오는 것을 막나?	잡귀	[WHAT]
라티움인이 사용하는 언어의 종류는?	인도-유럽어권	[WHAT]
암·수의 유전자를 반반씩 받아 새로운 생명을 만드는 생식은?	유성생식	[WHAT]
서터 킬리가 클럽과 음주에 빠지게 된 계기를 제공한 인물은?	캐시디	[WHO]
전라남도의 농악 중 육지의 것들과는 다른 독자성을 지니고 있는 것은?	도서해안굿	[WHAT]
소련에 잡혀 있던 마지막 전쟁 포로가 돌아온 해는 언제인가요?	1955년	[WHEN]
"""수리야""라는 단어가 일반 명사로 활용될 때 사용되는 또 다른 의미는?"	태양	[WHAT]
샤를 오퀴스탱 생트뵈브에서 이폴리트텐, 에르네스트 르낭을 거쳐 모리스에게 역사적 영향력을 준 인물은?	뉘마 퓌스텔 드 쿨라주	[WHO]
브란트가 내각의 해산을 제안한 인물은?	구스타프 하이네만 대통령	[WHO]
멕시코군의 요새에 식량을 조달하는 기차가 기습 공격당한 사건은 무엇인가?	글래스 파이트	[WHAT]
다모류가 냄새를 인식하는 부위는 무엇인가?	섬모구	[WHAT]
스파르타에서 비밀 암호를 사용했다고 주장한 인물의 이름은?	플루타르크	[WHO]
러일 전쟁의 승전국은 어디인가?	일본	[WHERE]
야야티의 아들이자 파우라바 왕국을 건국한 민족의 선조는 누구인가?	푸루	[WHO]
민족문제 연구소내에서 친일인사에 왕공족을 넣을지로 갑론을박하며 상당히 고심한 곳은?	편찬위원회	[WHERE]
영남 지방에서는 거의 발견할 수 없는 고인돌의 구조는 무엇인가?	탁자식 고인돌	[WHAT]
조선제국대학은 원래 예정일보다 얼마나 늦게 개교하였는가?	2달 가량	[WHEN]
바가 학살을 발생시킨 집단은?	보코 하람	[WHAT]
유명 작곡가들의 교향곡이 9번에서 끝난 것을 표현하는 말은?	제9번이 마지막 교향곡이 된다는 운명적 신화 (9번 교향곡의 저주)	[WHAT]
마르셀린이 자신의 감정을 보여주기 위해 쓴 음악의 제목은?	〈The Fry Song〉	[CITE]
마하트마 간디는 조만식의 어떤 활동에 긍정적이었나요?	물산장려운동	[WHAT]
2008년 FIBT 세계 선수권대회 개최국은?	독일	[WHERE]
카일로를 무찌르는데 사용한 무기의 이름은?	라이트세이버	[WHAT]
신돈이 마침내 궁에 들어와 살게 된 때는?	1364년	[WHEN]
요시다 성을 건축한 인물이 승리한 전쟁은 무엇인가요?	하이노하라 전투	[WHAT]
《모터사이클 다이어리》는 무엇을 모티브로 한 작품인가요?	《오토바이 남미 여행 일기》	[CITE]
짚신을 걸어두었던 돌을 의미하는 단어는 무엇인가요?	괘혁암	[WHAT]
빅뱅이 2012년에 열린 Mnet 아시안 뮤직 어워드에서 받은 것은?	"""가디언 앤젤 월드와이드 퍼포먼스상"""	[CITE]
활발한 느낌으로 시작해 조용한 분위기로 끝나는 부분은?	코다	[WHAT]
가힌샤 클럽에 두번째로 가입한 선수는?	하석주	[WHO]
제주 4.3사건 당시 조병옥의 직책은?	경무부장	[WHO]
도제의 변화가 있었던 시기는?	1177년	[WHEN]
김윤식에게 집행유예를 선고한 곳은?	육군계엄고등군법회의 재판부	[WHERE]
서민 귀족의 장르는?	코메디 발레	[WHAT]
심희가 집을 나왔을 때의 나이는?	9세	[QUANTITY]
16강 경기에서 알제리의 첫 골을 넣은 사람은?	압델무멘 자부	[WHO]
이토의 사망으로 위문사절단이 파견된 곳은?	청나라의 다롄	[WHERE]
가잔이 나우루즈의 굴복을 얻어낸 곳은?	니샤푸르	[WHERE]
최정규는 예전에 어디 소속이었나?	일진회	[WHERE]
팔성사의 8개의 작은 절마다 사는 사람은?	성인	[WHO]
대성전의 지붕을 옆에서 보면 무엇처럼 보이나?	사람 인	[WHAT]
레오니다스가 아카디아로 가기 전 머물렀던 곳은?	아테나 신전	[WHERE]
열펌프 보다 탄소배출량을 더 많이 배출하는 시스템은 어떤 연료를 사용하나요?	화석연료	[WHAT]
타티키오스가 비밀협상에 나선 것은 누구의 기록을 통해 알 수 있나요?	안나 콤네나	[WHO]
피르 볼그라는 이름은 어떤 의미를 지니는가?	"""배낭의 남자"""	[CITE]
1968년에 흑인으로서 최초로 연방 의원이 된 인물은 어느 도시 출신인가요?	해밀턴	[WHERE]
김세진의 죽음이 영향을 준 인물은?	박치음	[WHO]
이승조의 '평면과의 대결'을 높게 평가한 사람은?	김복영	[WHO]
노리쓰네와 같이 히요리도리고에의 고지대를 지킨 사람은?	미치모리	[WHO]
미하일 무루초스가 독일 선수에게 2번 모두 패배했던 해는?	1996년	[WHEN]
임신이 자연적으로 되지 않을 때 이용하는 방식은?	인공 수정	[WHAT]
넬리 킴이 금메달을 3개 획득한 올림픽은?	몬트리올 올림픽	[WHAT]
신체에서 만들어지지 않아 음식으로 보충해야 하는 지방산을 무엇이라고 하는가?	필수 지방산	[WHAT]
고권삼이 친일인명사전 수록예정자 명단 중 해외 부문에 포함된 이유는 무엇 때문인가?	황도철학이라는 어용 학문을 연구해 다수의 논설을 발표한 일	[WHY]
구원이 취소될 수 없다는 신학 사상에 반문한 사람은?	에라스무스	[WHO]
송세호가 '삼신리 2호'를 운영했다고 보도한 곳은?	《탐사기획 스트레이트》	[WHERE]
켄타우로스의 하체는 어떤 모습인가요?	말	[WHAT]
미국 독립전쟁 이전까지 버몬트를 억압하고 있던 국가는?	영국	[WHERE]
토마스가 죽은 뒤 존 설리번이 오기 전에 군대를 이끌었던 사람은?	윌리엄 톰프슨	[WHO]
니키아스가 27일을 기다리려고 하자 누가 공격했나요?	시라쿠사이	[WHO]
작가가 자신의 이상적인 자아상을 투영시킨 인물은?	파브리스	[WHO]
이스라엘의 음악단체들이 연주를 기피하는 작곡가는?	바그너	[WHO]
10군단의 장교가 아퀼라를 들고 적진으로 향할 당시 군대를 통솔하던 인물은 누구인가?	율리우스 카이사르	[WHO]
문제해결능력이 훌륭하면 결과적으로 최고로 향상되는 것은 무엇인가?	성과	[WHAT]
퐁파루드 여후작은 원래 어떤 신분이었나?	평민	[WHO]
그린란드의 기는 덴마크의 어떤 조직의 깃발과 똑같은가?	조정협회	[WHAT]
기독교 제단을 유지하며 전통 신을 섬긴 인물은?	래드왈드	[WHO]
1960년대 이전까지의 도시계획의 해결 대상이자 결과물이기도 한 것은?	도시문제	[WHAT]
2019년 한일청구권 협정 제 3조에 의거하여 일본이 대한민국 정부에 설립을 요구한 부서는?	중재위원회	[WHAT]
보물찾기 게임을 할 때, 누구를 통해 집안 곳곳의 보물을 발견해야 하는가?	이시노 요코	[WHO]
배철이 모국에 돌아오기 전 활동했던 정당은 어디인가?	일본공산당	[WHERE]
처녀가 태조를 만나기 전에 꾼 꿈에 나온 동물은 무엇인가요?	황룡	[WHAT]
뉴크로부존이 날씨에 영향을 줄 수 있도록 해 준 수단은?	기상조절기관	[WHAT]
기동전사 건담 SEED 중 만화판과 다르게 묘사된 화는?	제50화	[QUANTITY]
오토가 두 번째로 평신도 원장직을 맡은 수도원은 어디인가?	쇠팅가우	[WHERE]
추밀원이 영국 군주 앞에서 회의하는 것이 합법이라 주장한 사람은?	존 디펜베이커	[WHO]
아말감이 충분한 강도를 띠게 되는 것은 충전 후 얼마 이내인가?	1시간	[WHEN]
도자와시가 아오키를 해고했던 날짜는?	16일	[WHEN]
남조식물의 세포벽을 구성하는 주요 물질은?	뮤코펩티드	[WHAT]
모아치기에서 여러 키가 같이 입력되면 이들은 어떤 형태로 나타나나?	같은 음절로 결합	[WHAT]
가장 최근에 윔블던과 프랑스 오픈에서 모두 우승을 거머쥔 남성 선수는?	노박 조코비치	[WHO]
가포 앞바다의 자연이 치료에 도움이 되는 병은?	결핵	[WHAT]
그리스와 협상을 시도한 인물의 이름은?	마르도니우스	[WHO]
하산 쿠첵과의 싸움에서 진 하산 부즈루그가 결국 쫓겨간 곳은?	바그다드	[WHERE]
상대성 이론을 전제로 할 때에도 성립하는 법칙을 정의로 규정한 사람은 누구인가?	앙투안 라부아지에	[WHO]
상대적으로 노랫말 번역보다 자유로운 번역은?	시구 번역	[WHAT]
AMP-69에서 어댑터로 작동되는 부품은?	소염기	[WHAT]
림스역에서 북군을 공격한 남군의 장군은?	헨리 헤스	[WHO]
크렘린의 동쪽 벽 아래에 있는 해자의 길이는?	541m	[QUANTITY]
네모토 가족의 종교는?	정교회	[WHAT]
마운트 버넌이 미국의 국립역사기념물로 선정된 해는 언제인가요?	1960년	[WHEN]
군사력이 열세한 베트남에게 도움을 준 인물은?	유영복	[WHO]
수정의 밤'사건으로 사망한 유대인들은 최소 몇 명인가요?	91명	[QUANTITY]
삼존불의 재질은?	나무	[WHAT]
학생들이 공부하는 환경을 신경쓰지 못해 비난을 받은 인물의 직위는?	총장	[WHO]
아트워터흙파는쥐보다 더 작은 흙파는쥐는?	평원흙파는쥐	[WHAT]
천원삼태리마애불은 1964년 9월 3일에 무엇으로 선정되었는가?	대한민국의 보물 제407호	[WHAT]
이연우가 교통사고 이후에 깨어난 곳은 어디인가?	사후세계	[WHERE]
≪이것이냐 저것이냐≫에 등장하는 A의 사랑의 대상은 누구인가?	모차르트	[WHO]
제너럴 셔먼호 사건 당시 조선은 어떠한 공격 방식으로 셔먼호의 항행을 불가능하게 만들었는가?	화공	[WHAT]
가츠가 캐츠커의 안전을 위해 여행가기로 한 곳의 이름은 무엇인가?	엘프헬름	[WHAT]
페르난도의 아내가 사망했던 해는?	1504년	[WHEN]
성현의 위패를 모시는 곳이 위치하는 방향은?	뒤쪽	[WHAT]
표준형식 삼단논법에서는 소전제 전에 무엇이 먼저 나오나요?	대전제	[WHAT]
동성상업학교 교장으로 직무를 수행하기 전 장면의 직장은?	동성상고	[WHAT]
다비드의 벨기에 망명 당시 '마라의 죽음'을 프랑스 어딘가로 감춘 인물은?	앙투안 장 그로	[WHO]
1800년대에 일본인들에게 가장 많은 영향을 준 서양의 나라는?	네덜란드	[WHERE]
그리스의 고대 올림픽 경기에 참여할 수 있는 자격은 무엇인가?	순수 그리스인	[WHAT]
보로메오 가문의 문장은 어떤 의미를 지니고 있었나요?	삼위일체	[WHAT]
단순포진 각막염의 흰색 병변은 심한 경우에 무엇을 일으키나요?	각막 궤양	[WHAT]
주인공에게 매번 살려달라는 간청을 받았던 인물은?	메그	[WHO]
위현의 아들중 작위를 이어받은 사람은?	위현성	[WHO]
오버헤드를 감소시키기 위해서는 무엇을 크게 만들면 되는가?	클러스터	[WHAT]
선장과 선교사 토마스를 구타하여 살해한 사람들은 누구인가?	평양 부민들	[WHO]
12월 14일에 약 150명의 사상자가 나온 부대는?	알제리 저격병 대대	[WHAT]
지브롤터 유나이티드가 리그에 남아있기 위해서는 언제까지 빚을 갚아야 했는가?	8월 12일까지	[WHEN]
방어력이 다른 타입보다 좋은 포켓몬은?	강철 타입 포켓몬	[WHAT]
펜이 대표적 정부를 설립한 해는 언제인가?	1682년	[WHEN]
체력아이템이 없는 경우 둘리의 체력을 회복하려면 누구를 처치해야 하는가?	보스	[WHO]
악한 동시에 선하다고 믿어진 여신은?	시탈라	[WHAT]
초등학생들에게 일본 원폭 투하 내용을 교육하고 있는 나라는?	쿠바	[WHERE]
세월호 유가족에게 사과하는 것을 거부한 사람은?	김시곤 보도국장	[WHO]
토하라어는 인도이란어와 켈트어 중에서 무엇과 더 유사한가?	켈트어	[WHAT]
브루클린과 스태튼 아일랜드를 나누어지도록 한 다리가 있는 해안은?	뉴욕만	[WHAT]
헬레네 바이겔의 남편은?	브레히트	[WHO]
알 수 있는 사람을 사기꾼 또는 다른 사람으로 인식하는 증세의 병명은?	카그라스 증후군	[WHAT]
에끌레르가 주산도 남쪽에서 청나라 해군을 발견한 것은 언제인가요?	2월 13일	[WHEN]
회은은 어느 시대의 승려였나요?	조선 중기	[WHO]
제8호 열대저기압의 원천 파동이 안틸레스 제도에 도달한 날짜는?	8월 29일	[WHEN]
Cosmo's Factory를 제작해 판매한 팀은?	크리던스 클리어워터 리바이벌	[WHAT]
프레스코가 유명한 곳은 언제부터 세르비아 공화국이 보호해주었나요?	1979년	[WHEN]
폭동에 가담한 일부 조선인이 있다고 발표한 일본 정부 부처는?	법무부	[WHAT]
갬블러 VS. 초능력자의 작가는 누구인가?	마사토끼	[WHO]
카르티니는 아이를 낳고 며칠 뒤에 목숨을 잃었는가?	나흘	[WHEN]
블루어 역의 설계를 바꾸게 만든 건물은 무엇인가요?	제록스 센터	[WHAT]
오자와가 잃은 항공모함은 모두 몇 척인가?	4척	[QUANTITY]
하정우가 학원 말고 연기를 배운 곳은?	매니지먼트 회사	[WHERE]
민족주의 민족전선의 의장으로 옹립된 사람은 몇 명인가?	5인	[QUANTITY]
너목보에 출연해 노래 실력을 뽐낸 배우는 누구인가?	김민규	[WHO]
현미경 없이는 볼 수 없는 점에서 어떤 문구를 볼 수 있나?	'너는 여기 있다'	[CITE]
장수 개인의 특성 중 유일하게 다시 추가된 능력치는?	통솔	[WHAT]
우리나라 고인돌의 형식 중 지석묘는 무엇에 해당하는가?	바둑판식 고인돌	[WHAT]
기력이 다한 듀라가 마지막 남은 힘을 쏟은 곳은?	아티팩트	[WHERE]
중세 시기 삼경법이 이루어지는 밭 중 세균이나 몇몇 식물의 질소 고정 작용이 일어나는 것은 몇 번째 밭인가?	세번째 밭	[WHAT]
김민기의 자식들이 설립한 것은?	디자인회사	[WHAT]
여러 명의 군사들이 각 부분을 나눠 옮겨야했던 포가 발명된 시기의 왕는?	펠리페 2세	[WHO]
데이비드는 어떻게 정체를 숨겼나?	우비를 뒤집어 써 얼굴을 감춘	[HOW]
1962년 이래 처음 몬 언어로 작성된 신문은?	탄윈 타임즈	[WHAT]
슈트라우스의 음악에서 모차르트의 음악 형태를 띈 악장의 끝에 중심적으로 연주되는 악기는?	호른	[WHAT]
중국 황제가 마지막으로 직접 군사를 이끌고 공격한 곳은?	몽골	[WHERE]
새로운 차르가 등용된 후 가짜 드미트리가 도망간 장소는?	칼루가	[WHERE]
마드리드 지하철 7호선에서 요금구역이 나누어지는 역은?	에스타디오 메트로폴리타노 역	[WHAT]
토머스는 어떤 사건으로 인해 1년간의 보호 관찰을 받았나?	USS 사라토가 호에서 조지 로엡이 흑인 수병 해럴드 J. 맨스필드를 총으로 쏘아 살해한 사건	[WHAT]
자산가치를 높여 탑클래스 고객을 만족시키는 고품격 서비스를 하기 위해 운영하는 것은?	“세무상담 및 부동산 법률상담”	[CITE]
7B선으로 환승하기 위해서는 어느 역으로 가야하나요?	에스타디오 메트로폴리타노 역	[WHAT]
볼드윈이 없는 것이 낫다고 표현한 사람은?	처칠	[WHO]
예브게니야가 살았던 도시는?	사라예보	[WHERE]
학계는 인도가 언제부터 철을 주로 사용해 도구를 만들었다고 생각하나요?	기원전 11세기	[WHEN]
사쿠라기고교 제50대 응원단의 고수장이 원래 속했던 동아리는 어디인가?	취중악부	[WHERE]
코스모케라톱스의 갈고리 모양 장식은 대부분 어느 쪽으로 굽어 있는가?	앞쪽	[WHAT]
새정부를 만드는데 가담하지 않은 사람은?	촘베	[WHO]
아서왕이 엑스칼리버 처리를 명령한 사람은?	베디비어 경	[WHO]
사람들의 일상을 면밀히 지켜보며 신체기관의 기능을 파악하라고 얘기한 인물은?	리처드 얀츠 (Richard Jantz) 박사	[WHO]
프랑스에서 누에 전염병이 돈 해는?	1865년	[WHEN]
비트켄슈타인 가문을 혼혈로 인정한다는 내용이 담긴 문서에 서명한 자는 누구인가?	아돌프 히틀러	[WHO]
웨이파인딩의 기원이 된 것은 어떤 사람들과 관련이 있나?	폴리네시아 토착민	[WHAT]
가스타우스 루미스 대령이 이끌지 않았던 군부대의 이름은 무엇인가?	제5보병대	[WHAT]
요한 9세의 후임자는 누구인가?	교황 베네딕토 4세	[WHO]
로버트 모리스 수석의 아들이 태어난 곳은?	영국의 랭커셔	[WHERE]
샤우만이 총독을 저격할 때 사용한 총은?	FN M1900	[WHAT]
영자초를 진귀한 재화라 평가한 사람의 직업는?	상인	[WHO]
왕궁의 재산을 처분할 권한이 없던 왕은?	샤를	[WHO]
핀란드 원정대가 로데이노예폴레에 도달한 것은 몇 월인가?	4월	[WHEN]
바이로플라즘이 주로 자리 잡고 있는 곳은?	MTOC 주변	[WHERE]
미국이 여러 범죄의 본거지로 파악하던 지역은?	아부 카말	[WHERE]
벤구리온은 누가 유엔결의안을 수용하지 않았다고 주장하였나?	아랍인	[WHO]
전후민주주의가 전통문화를 파괴했다고 비판했던 당은?	자유민주당	[WHAT]
표면온도가 100만 켈빈 이하인 중성자별은?	펄사 PSR J0205+64	[WHAT]
호미나 칼 낫등의 자루 속에 들어가는 일부는?	슴베	[WHAT]
엄상궁이 의친왕을 밀어내었던 것은 누구를 위함인가?	자신의 아들 황자 이은	[WHO]
흥법국사의 탑이 마지막으로 이동된 곳은 어디인가?	국립중앙박물관	[WHERE]
뉴펠드 협회가 자리잡은 지역은?	캐나다 벤쿠버	[WHERE]
미스터파크는 강대구와 정순례가 누구의 시신을 옮길 것이라고 예상하였나?	살인 청부업자	[WHO]
한글판 스타크래프트 : 고스트에서 동양미를 갖추게 된 인물은?	주인공 노바	[WHO]
스위니가 테네시에서 무엇을 도둑질 한 것으로 전해지나?	말	[WHAT]
2005년 에너지 정책법으로 인해 일광 절약 시간제의 기간이 바뀐 국가는?	미국	[WHERE]
기욤 뮈소의 작품에서는 주로 서스펜스와 어떤 장르의 조합을 볼 수 있는가?	로맨스	[WHAT]
시마즈가 조선인 포로에 대한 조치를 취하지 못한 것은 무엇 때문인가?	세키가하라 전투	[WHAT]
재일여대생이 여운형 이후에 만난 남자의 정체는?	일본 밀정	[WHAT]
유스티누스 1세는 어떤 사상을 따르는 성당을 전부 봉쇄하였나?	아리우스주의	[WHAT]
뫼비우스가 도마뱀의 유전자를 이용하여 만든 인물은?	클라인	[WHO]
2019년 1년 법원장 탄핵소추안과 관련된 기자회견을 연 단체는?	민주사회를 위한 변호사 모임	[WHAT]
고종이 8월이 되서야 고구려를 공격했던 것은 어떤 조직 때문이었나요?	백제부흥군	[WHAT]
운장대가 문장대로 불리게 된 것은 어떤 왕과 관련있나?	세조	[WHAT]
지석묘가 만들어진 시기는?	청동기시대	[WHEN]
조소문화협회가 만들어진 시기는?	1945년 11월 11일	[WHEN]
여소가 황제를 양보하려한 인물에 대해 부정적으로 말한 사람은?	여초(呂超)	[WHO]
엔트로피에서 배제하는 것은?	사건 자체의 의미	[WHAT]
암살자로부터 정몽주를 지키려다 죽은 사람은?	김경조	[WHO]
두위밍이 창춘 시를 점령한 해는?	1946년	[WHEN]
특수 상대성이론의 확장판을 발표한 사람은?	아인슈타인	[WHO]
보니파시오 4세가 사망한 해는?	615년	[WHEN]
1902년 쿠데타 사건에서 천장욱은 누구에게 돈을 대주었는가?	유길준	[WHO]
페르시아계 가문에서 가장 처음 알려진 인물은?	키우스의 미트리다테스	[WHO]
철기 시대에 인도유럽어족의 이란인들이 집권했던 곳은 어디인가?	이란 고원	[WHERE]
A방의 온도가 높아진다면 무엇도 같이 높아지는가?	평균분자속력	[WHAT]
제3세계와의 협력을 거부하고 고립주의적 전술을 택하는 단체는?	트로츠키주의파	[WHAT]
알아크사 방위대가 비공식적으로 권력을 배분하기로 협의한 단체는?	파타 인티파다	[WHAT]
칠무늬토기의 별칭은?	채도	[WHAT]
학교형태의 평생교육시설이 어떠한 목적으로 이용되는 것을 막아야 하는가?	고등학교를 보다 일찍 졸업하기 위한 수단	[WHAT]
벳지가 부하들에게 '파더'로서 칭해지던 조직의 이름은?	파이어탱크 해적단	[WHAT]
코소보의 새 국기에 있는 하얀 별의 갯수는?	6개	[QUANTITY]
유수일에게 선교회에 대해 말해준 인물과 같이 다닌 학교는?	서울대학교	[WHERE]
두 번째 선거에서 빌 클린턴은 누구를 상대로 승리하였나?	밥 돌	[WHO]
니카라과 사건에 대해 내정간섭 여부를 판시한 주체는?	ICJ	[WHAT]
달 무지개는 어디서 가장 잘 보이는가?	보름달 근처	[WHERE]
수천부정에 봉작된 인물은?	이정은	[WHO]
미국인들이 만지로를 부른 별명은?	존맨	[WHAT]
베토벤의 피아노 협주곡 5번이 베토벤의 살아생전 마지막으로 연주된 것은 몇 년인가?	1812년	[WHEN]
프로비던스와 함께 가장 먼저 노예제를 없앤 곳은?	로드아일랜드 주	[WHERE]
장재헌의 조상이자 임진왜란 당시 선조의 피난을 도와 공을 세운 이는?	장만리	[WHO]
여러 유럽군대나 자위대에서 참모총장직을 수행하는 계급은?	중장	[WHO]
지석묘는 언제 만들어졌나요?	청동기시대	[WHEN]
"엘리자베스 ""베티"" 헤밍스의 손자이름은?"	조셉 포셋	[WHO]
삼한총왕설을 부정한 역사학자는 누구인가?	천관우	[WHO]
빅뱅 월드 투어 티켓 판매를 시작함과 동시에 티켓 품절 사태가 발생한 국가는?	싱가포르	[WHERE]
우르바노 5세가 십자군동원을 명령한 연도는?	1362년	[WHEN]
일반차가 역전 광장의 주차장에 들어올 수 없는 시기는 언제인가?	"매년 4월 ""고베 역 화도 축제"""	[WHEN]
마을 전체를 불태운 것은?	네이팜탄	[WHAT]
171기의 유구가 나온 시대보다 집터가 작았던 시기는?	청동기 시대	[WHEN]
사랑 또는 돈에 대한 변화를 의미하는 행성은?	금성	[WHAT]
일부 스토커들에게 이상현상지역에 접근했음을 알 수 있게 해주는 도구는?	이상현상 측정기	[WHAT]
보살상의 제작자를 알 수 있는 기록물이 발견된 곳은?	보살상의 몸속	[WHERE]
포룸에 있던 건물들을 보존하기 위해 노력한 사람들이 사는 곳은?	로마 시	[WHERE]
루이지애나를 미국에 넘긴 나라는?	프랑스	[WHERE]
사쿠라기 고교에서 촉망받는 1학년 학생은?	오시마 히데키	[WHO]
베네치아 공화국에서 법안 하나 발의할 때 원수 보좌관 절반 이상의 동의를 받아야 하는 직책은?	도제	[WHO]
숫자 7698의 정체는?	이정숙 양 집의 전화번호 뒷자리	[WHAT]
라오스가 프랑스로부터 형식적인 독립을 얻어낸 년도는?	1949년	[WHEN]
1915년의 크리스마스의 정전이 1914년만큼 광범위하지 않았던 이유는?	양측 다 지휘부가 강력히 정전을 금지하였기 때문	[WHY]
강희제는 장병 간의 관계가 어떻다고 믿었나?	일심동체	[WHAT]
하녀의 청을 받고 팔라다를 죽인 사람은?	왕자	[WHO]
양말공장을 경영했던 평양의 거장 기업가는?	박치록	[WHO]
노예제도를 없애기 위해 법률을 만든 유일한 식민지는?	어퍼 캐나다	[WHERE]
쿠바 혁명 이전 쿠바의 정치 체제는?	자본주의 체제	[WHAT]
워너는 언제 재혼했는가?	1936년	[WHEN]
이마무라와 다스다에게 참수형을 선고한 기관은?	후쿠오카 임시 법원	[WHAT]
북한은 개건 현대화를 위해 조립 라인과 함께 무엇을 복구하였나?	가공 라인	[WHAT]
높은 압축비의 엔진이 주의해야 하는 현상은?	노킹 현상	[WHAT]
조지가 런던탑에서 쫓겨난 해는?	1986년	[WHEN]
HH 천체가 희미하게 나타나는 파장은?	가시광선 파장	[WHAT]
물이 잘 나오는 우물 9개가 있어서 생겨난 마을이 처음 불리게 되었던 명칭은 무엇인가?	구우물	[WHAT]
아반티파타의 지방 회계를 맡은 직책은?	"""유크타"""	[WHO]
채권투자전략을 둘로 나누었을 때 비교적 공격적인 전략은 무엇인가?	적극적 채권투자전략	[WHAT]
베르뇌 주교와 함께 정의배의 삶을 좋게 평가한 사람은?	다블뤼 주교	[WHO]
신한국당이 의석 과반수를 차지하기 위해 필요했던 의석 수는?	150석	[QUANTITY]
메이지 시대 이후에 존재하던 마지막 원로는 누구인가요?	사이온지 긴모치	[WHO]
잘못 표기된 표를 유효표로 처리할 수 있는 권한을 가진 기관은?	선거관리위원회	[WHAT]
부당이득 반환청구 소송 진행의 기초가 되는 법 영역은?	민법	[WHAT]
각 군단에서 황제의 이마고가 새겨진 창을 들고 다니는 장교를 일컫는 명칭은?	이마그니페르	[WHAT]
루페르칼리아 축제를 금지시킨 사람의 시신이 안치된 날짜는?	11월 21일	[WHEN]
꼬리마리오가 게이지 쿨타임이 없어질 때까지 계속해서 날기 위해서 채워야 하는 것은?	P게이지	[WHAT]
탄수화물이 지방산으로 바뀌는 과정에서 가장 먼저 무엇으로 변화하는가?	피루브산	[WHAT]
강희제가 수녀제를 본받도록 만든 이는?	부황 순치제	[WHO]
인도네시아가 OPEC에서 빠진 까닭은?	석유 산출량 부족	[WHAT]
가평으로 향하는 적군을 목격할 당시, 김근호 대위는 어디로 가고 있었나?	303고지	[WHERE]
세계에서 가장 오랫동안 감옥에 있었던 인물은?	김선명	[WHO]
매우 보편화된 신약성서의 텍스트는?	텍스투스 레셉투스	[WHAT]
《하유교목 아망천당》의 의미는 무엇인가?	'여름에는 교목이 있고 야왕은 천국을 바라본다'	[CITE]
1919년 독립 시위 주문을 한 인물이 능통했던 언어는?	불어	[WHAT]
사람들은 왜 고양이처럼 생긴 바위를 지나갈 때마다 말에서 내려 걸어갔는가?	말발굽이 땅에 붙어 떨어지지 않으므로	[WHY]
사사카와 료이치가 가장 오래 갇혀 있었던 곳은 어디인가?	오사카 형무소	[WHERE]
굿펠로우나무타기캥거루가 몸을 앞으로 숙여서 균형을 맞추려 하는 신체부위는?	무거운 꼬리	[WHAT]
모스테파이 본인과 집안이 정상적이었으며 특이한 점은 없었다고 말한 자들은?	모스테파이의 옛 이웃들	[WHAT]
서울 시민 4분의 1 가량이 여의도에서 구경했던 비행이 실시된 때는?	1917년 5월	[WHEN]
오다와라 역에서 출발하는 하코네유모토 행 특급열차의 소인 좌석권은 얼마인가?	100엔	[QUANTITY]
트리톤이 해왕성의 위성 궤도에 들어온 후 변화가 생긴 것으로 추측되는 것은?	기존 위성들의 궤도	[WHAT]
소수의 글로벌 회사가 유명 식품 회사를 관리하기 시작한 것은 언제부터인가?	21세기	[WHEN]
라틴 동맹을 대표하는 신전은 누구를 위해 만들어졌는가?	다이애나 여신	[WHO]
프랑수아 뒤발리에를 뒤를 이어 대통령이 된 자는?	장클로드 뒤발리에	[WHO]
차오관희가 일본에서 다닌 대학은?	도쿄 대학	[WHAT]
체력부족으로 은퇴한 인물이 손을 잡은 인물은?	프로페서 코브라	[WHO]
실버를 다시 조사하자고 말한 인물의 직업은?	물리학자	[WHO]
아미타불을 중심으로 우측 지장보살은 오른손에 어떤 물건을 쥐고 있는가?	구슬	[WHAT]
오드리 헵번과 그랜트의 나이 차이는?	25살	[QUANTITY]
대교파출소는 어떤 사람한테서 장난 전화를 받았는가?	김현정 양을 살해한 범인	[WHAT]
튀르크인이 영토를 빼앗아갈 무렵 유행하던 전염병은?	흑사병	[WHAT]
1874년 주의회가 연달아 택한 법은 무엇에 대해 규정하고 있나요?	화물운임	[WHAT]
음모자들이 테오도어 코르트를 통해 접선하고자 한 나라는?	영국	[WHERE]
흑표당이 실현하고자 했던 말콤X의 사상은?	말콤X의 자기방어 철학	[WHAT]
원진국사비가 만들어진 시기는?	고려시대	[WHEN]
919년에 선출된 독일의 군주는 어디 출신이었나요?	색슨족	[WHERE]
빌리 선데이는 누구를 대상으로 종교적인 믿음을 활용해 희망적인 메시지를 전달하였나?	미 국민	[WHO]
힌두어를 인도 공용어로 지정하는 것에 반대하는 민족은?	드라비다어 족	[WHAT]
미디어 아트는 역동적인 전시물과 무엇의 상호작용을 중시하는 예술인가요?	관람객	[WHAT]
징효국사의 스승은 누구인가?	철감선사 도윤	[WHO]
금강산 개발 사업을 결정하게 한 시초가 된 정부의 정치적인 방책은?	대북 햇볕 정책	[WHAT]
조선 전기의 양식을 반영해서 화강암으로 만든 것은?	봉분	[WHAT]
한국어 야간 수업은 언제부터 시작되는가?	매일 밤 10시	[WHEN]
<자랑거리>가 다시 극장에 나왔을 때 주인공을 맡은 여자는?	헬렌 헤이즈	[WHO]
버러 마켓은 본래 어느 다리의 끝부분과 맞닿아 있었나요?	런던브리지	[WHAT]
레닌의 전위당론을 엘리트주의라며 비판한 사람은?	아나키스트 FAQ의 저자	[WHO]
칸 박사가 우라늄 농축에 사용되는 원심분리기를 보낸 나라는 어디인가?	조선민주주의인민공화국	[WHERE]
개신교와 가톨릭 신자들이 수감되었던 시위는 어디에서 행해졌는가?	워싱턴 DC	[WHERE]
복식이 무제에게 하사받은 직위는 무엇이었나요?	중랑	[WHAT]
헤라클레스의 아내가 그에게 주었던 것은?	옷	[WHAT]
워렌 연방대법원장 시기의 정부 혹은 의회는 어떤 성향을 띄었는가?	보수적	[WHAT]
뉴욕 필하모닉 최초의 미국인 상임 지휘자는 누구인가?	시어도어 토머스	[WHO]
카탈루냐 지방에 다시 나타난 늑대는 어디서 왔는가?	프랑스	[WHERE]
진덕여왕은 누구 다음으로 왕의 자리를 차지하였는가?	선덕여왕	[WHO]
여름방학동안 치에는 어디에서 지내기로 하였나요?	쇼헤이의 집	[WHERE]
제국과 메시나를 두고 전쟁을 벌인 민족은?	사라센인	[WHAT]
차바하르항은 이란 항구 중 어느 국가의 제재를 유일하게 받지 않았나?	미국	[WHERE]
개인적 요소와 상황적 요소로 설명되는 내집단 구성원의 행동 양식은 어디에 보고돼있나?	상호집단관계에 관한 문헌	[WHERE]
부의 근원은 농업밖에 없다고 여기던 사상은?	중농주의	[WHAT]
현재 동구에서 가장 큰 동은?	송현2동	[WHAT]
의무교육과정이 끝나고도 아일랜드어를 쓰는 지역은?	게일타흐트	[WHERE]
밤이 되면 공기가 위로 올라가는 곳은 육지와 바다 중 어디인가?	바다	[WHERE]
캐나다 민요는 주로 어느 나라의 민요와 똑같은가?	프랑스	[WHERE]
섭정가의 경제 기반에 큰 타격을 준 명령이 발포된 시기는?	1069년	[WHEN]
리처드 2세가 왕권을 도발했다는 이유로 없애기 시작한 집단은?	의회파들	[WHAT]
니콜라오 2세가 장엄한 예식을 주재함으로써 우호관계를 형성한 세력은?	노르만족	[WHAT]
세이부 라이온스라는 구단명이 정해진 연도는?	1978년	[WHEN]
창조론과 모순되어 출판 당시 큰 논란이 발생한 찰스 다윈의 저서는?	《종의 기원》	[CITE]
토니 메이가 질산 암모늄 폭발물의 뚜렷한 특징이라고 밝힌 것은?	노란 연기 구름	[WHAT]
카이사르가 도버에 상륙하려고 했던 근거를 제시한 인물은?	볼루세누스	[WHO]
1379년에 이탈리아의 주요 거점지로 인정받았던 장소는?	베니스	[WHERE]
독립 국가로서 콩고의 첫 번째 총리는 누구였나?	루뭄바	[WHO]
메이토구를 가로지르는 노선의 마지막 역은?	후지가오카 역	[WHAT]
종을 단순히 형태적 특징만으로 정의한것은 무엇인가?	형태종	[WHAT]
링컨이 노예 해방 선언을 공표한 해는?	1863년	[WHEN]
쇼기대의 본관은 우에노로 이동하기 이전에 어디에 있었나요?	혼간지	[WHERE]
오삼계는 무엇을 등 뒤에 부착하라고 명령했는가?	흰 옷	[WHAT]
아이작 뉴턴이 제1법칙에 대해 정의내린 저서는?	자연철학의 수학적 원리	[WHAT]
별의 주요 작용 원리는 복사 에너지를 무엇으로 바꾸는 것인가?	맥동 에너지	[WHAT]
아그노디케는 누구에 의해 오브스테트릭스라고 서술되었나요?	히기누스	[WHO]
와카바야시의 추계 리그 3번째 우승은 몇 년인가?	1934년	[WHEN]
부견의 동진 공격을 지지한 사람은?	모용수	[WHO]
2012년에 부일장학회의 주식반환에 대해 기각 결정을 내린 재판부는?	서울중앙지법 민사합의17부	[WHAT]
역감시는 무엇의 보호를 위한 활동인가요?	자신의 프라이버시	[WHAT]
알래스카 고속도로가 미국 본토에 수행하는 역할은?	병력과 물류를 보급할 통로	[WHAT]
영류왕이 천리장성의 건축 총괄 책임을 맡겼던 인물은 누구인가?	연태조(淵太祚)	[WHO]
대부분의 이오의 산이 형성되는데 영향을 끼친 것은?	지질 구조	[WHAT]
애니는 어디서 태어났는가?	뉴저지	[WHERE]
1854년에 니콜라이의 뒤를 이어 상임 지휘자로서 활동한 인물은?	칼 에케르트	[WHO]
드래곤의 암수 구분이 있는 신화는?	슬라브 신화	[WHAT]
올레 폰 보이스트 이후에 시장으로 임명된 사람은 누구인가?	크리스토포 알하우스	[WHO]
